userid,age,dob_day,dob_year,dob_month,gender,tenure,friend_count,friendships_initiated,likes,likes_received,mobile_likes,mobile_likes_received,www_likes,www_likes_received
1988963,18,23,1995,9,male,608,502,326,101,5,13,0,88,5
1721951,22,23,1991,4,male,501,501,411,104,134,14,88,90,46
1215753,19,12,1994,8,male,392,512,402,102,82,102,68,0,14
1862120,41,17,1972,6,male,413,509,412,111,59,0,7,111,52
1772104,16,20,1997,12,female,581,511,363,111,93,0,19,111,74
1346427,28,9,1985,11,male,1182,501,358,113,74,113,73,0,1
1075555,30,15,1983,10,male,542,503,373,119,68,110,42,9,26
1237980,30,1,1983,3,male,1691,510,226,119,456,101,204,18,252
1371925,20,29,1993,1,female,274,508,61,115,452,115,358,0,94
1500830,16,15,1997,8,male,295,514,295,121,121,58,110,63,11
1988691,15,3,1998,3,female,447,512,278,124,84,117,61,7,23
1279005,15,3,1998,3,female,991,503,240,122,293,117,93,5,200
1801981,16,2,1997,6,male,396,509,360,128,19,38,10,90,9
1468006,17,27,1996,11,female,224,512,304,126,156,26,66,100,90
1271571,21,2,1992,11,female,438,511,392,125,54,123,27,2,27
2108565,18,5,1995,4,female,245,500,336,127,137,111,75,16,62
1316593,17,22,1996,4,male,617,502,322,133,260,56,135,77,125
1809350,35,4,1978,9,female,556,516,313,135,159,131,127,4,32
1086253,28,17,1985,9,female,1690,507,201,132,284,132,184,0,100
1091201,21,9,1992,9,male,1071,517,250,137,141,38,36,99,105
1618226,33,21,1980,6,male,612,512,422,137,55,132,30,5,25
1060707,16,19,1997,1,male,619,513,407,140,112,133,50,7,62
1188269,33,1,1980,2,female,1684,505,144,142,1897,128,1490,14,407
2056368,17,29,1996,8,male,258,503,304,138,121,138,114,0,7
1284874,26,12,1987,10,male,270,511,94,150,576,65,433,85,143
2026302,20,2,1993,9,female,232,500,181,146,765,118,470,28,295
1879338,18,25,1995,1,female,350,500,48,148,222,148,165,0,57
1963338,28,22,1985,4,female,656,506,299,149,354,149,138,0,216
2033032,25,29,1988,5,male,1177,513,327,154,100,152,62,2,38
1897497,26,26,1987,1,male,1234,510,124,155,125,153,82,2,43
1624464,39,20,1974,5,male,207,515,438,151,194,142,144,9,50
1721658,21,29,1992,7,male,628,505,359,156,284,145,224,11,60
1534021,19,23,1994,11,male,259,500,433,157,72,157,66,0,6
2173551,23,15,1990,12,female,1496,502,235,162,1044,24,522,138,522
1684363,18,12,1995,2,male,682,516,344,163,150,163,125,0,25
1980911,21,6,1992,6,female,191,510,274,166,442,94,202,72,240
1820338,20,9,1993,3,female,601,508,298,168,392,132,201,36,191
2036606,18,5,1995,6,female,218,510,313,177,139,74,106,103,33
1569441,17,27,1996,5,female,584,507,330,178,428,106,341,72,87
1228816,18,5,1995,9,female,301,504,372,176,174,176,162,0,12
2152904,31,31,1982,1,female,397,505,472,198,207,108,123,90,84
1427641,17,11,1996,2,female,701,507,174,204,58,20,38,184,20
1767625,21,7,1992,6,male,162,500,461,206,425,206,414,0,11
1019749,15,23,1998,6,female,467,507,375,221,61,14,4,207,57
2116086,17,3,1996,6,female,64,505,396,212,793,202,215,10,578
2112849,28,24,1985,3,female,418,512,413,216,236,216,161,0,75
1058304,18,26,1995,6,female,538,516,306,223,103,203,31,20,72
1895253,24,27,1989,11,female,416,503,207,224,212,215,142,9,70
1577324,19,5,1994,4,female,506,512,139,233,73,233,73,0,0
2129244,23,3,1990,3,male,314,514,384,222,125,222,117,0,8
1395458,20,25,1993,2,male,270,507,281,246,326,198,178,48,148
1509088,17,21,1996,9,male,431,502,254,235,80,235,76,0,4
1403738,19,8,1994,2,female,276,500,320,254,328,250,226,4,102
1339774,24,22,1989,11,male,695,503,207,250,360,212,201,38,159
1855227,17,26,1996,8,female,511,507,221,247,68,246,52,1,16
1112369,15,13,1998,2,female,595,501,276,271,177,101,102,170,75
1270387,16,22,1997,1,female,566,505,232,271,177,70,33,201,144
1884288,23,21,1990,8,female,333,514,158,270,378,245,114,25,264
1071670,17,18,1996,12,female,683,514,291,271,520,238,390,33,130
1999717,23,30,1990,3,male,667,505,260,267,143,267,107,0,36
1727788,15,7,1998,8,female,130,514,354,264,478,264,429,0,49
1758410,27,19,1986,2,male,608,515,365,290,184,18,39,272,145
1224356,24,30,1989,5,female,598,504,246,277,495,142,154,135,341
1318180,40,8,1973,5,female,1706,517,413,279,390,254,95,25,295
1748710,41,10,1972,5,male,480,508,464,279,16,279,14,0,2
2028245,18,20,1995,12,female,304,515,475,283,128,283,125,0,3
1035246,25,19,1988,5,female,542,502,167,283,237,283,218,0,19
1169146,23,20,1990,6,female,1507,509,194,308,512,149,176,159,336
1515966,17,4,1996,5,male,354,502,357,296,98,295,36,1,62
1558128,18,13,1995,2,male,283,509,354,322,94,0,52,322,42
1394096,18,5,1995,1,female,658,509,335,317,975,116,281,201,694
1090439,19,26,1994,12,female,437,515,306,312,164,312,127,0,37
1490525,21,4,1992,12,male,847,513,151,344,61,344,39,0,22
1421308,22,30,1991,11,female,1210,510,77,339,428,339,283,0,145
1930301,18,15,1995,3,female,529,514,264,361,299,11,54,350,245
1127556,21,4,1992,3,female,494,514,202,367,290,349,206,18,84
1360603,27,3,1986,1,female,2174,505,293,360,416,295,301,65,115
1185393,17,31,1996,5,female,352,517,214,360,239,360,120,0,119
1195126,23,8,1990,6,female,659,514,332,370,21,201,8,169,13
2121204,18,20,1995,7,female,395,500,434,376,253,104,160,272,93
1500324,28,4,1985,11,female,257,509,443,392,403,252,322,140,81
2079370,26,27,1987,7,female,84,500,251,382,242,334,118,48,124
2187814,20,18,1993,10,female,474,517,382,397,515,154,115,243,400
1731682,16,26,1997,8,male,523,513,302,409,569,366,276,43,293
2188174,14,21,1999,1,male,350,505,399,415,92,415,47,0,45
1941218,24,8,1989,12,female,552,509,175,395,68,395,56,0,12
1401608,17,30,1996,6,male,511,500,376,417,355,417,235,0,120
1005719,35,12,1978,3,female,625,508,373,402,400,402,305,0,95
1561986,18,15,1995,9,male,285,508,363,444,134,444,116,0,18
2162098,23,18,1990,9,male,518,511,295,460,294,207,160,253,134
1252264,15,14,1998,8,male,388,513,432,461,935,224,421,237,514
1714065,21,5,1992,5,female,1327,512,281,466,204,455,99,11,105
1870848,31,13,1982,8,female,975,505,218,514,955,283,410,231,545
1371797,29,8,1984,9,female,615,503,355,484,553,424,395,60,158
1765464,13,10,2000,3,female,545,515,274,560,326,436,222,124,104
1680987,19,29,1994,1,female,824,515,429,561,170,511,112,50,58
2042749,40,8,1973,2,female,55,500,437,524,418,504,376,20,42
1355593,22,26,1991,6,female,653,502,339,568,342,35,133,533,209
1015194,19,29,1994,11,female,1167,515,228,590,720,309,281,281,439
1352993,19,8,1994,5,male,301,512,261,588,461,569,291,19,170
1776442,29,3,1984,4,male,373,516,327,603,646,603,605,0,41
1314160,16,9,1997,7,male,328,507,312,647,134,124,49,523,85
1267953,18,30,1995,6,female,917,510,352,640,482,441,262,199,220
2007970,25,26,1988,9,female,555,500,144,655,1967,459,1454,196,513
1367290,29,10,1984,10,female,1238,515,236,612,443,612,351,0,92
1312201,24,21,1989,11,female,531,509,355,697,304,626,99,71,205
1427648,14,19,1999,10,female,249,502,309,678,482,582,247,96,235
1858755,19,6,1994,6,female,403,517,107,792,186,159,127,633,59
1791127,21,6,1992,2,female,139,500,151,779,986,777,411,2,575
1003485,23,19,1990,3,male,158,509,433,841,1272,519,445,322,827
1114385,19,20,1994,10,male,615,518,426,862,874,750,344,112,530
1450554,22,18,1991,5,female,337,515,247,833,1275,833,954,0,321
2042944,20,8,1993,4,female,213,509,269,926,561,165,253,761,308
1893435,21,28,1992,10,female,308,517,174,957,557,102,319,855,238
2038896,16,9,1997,9,male,128,504,351,932,1034,892,935,40,99
1629204,15,28,1998,7,female,283,517,265,985,1815,876,903,109,912
1178292,20,15,1993,5,female,444,504,386,994,782,99,134,895,648
1797904,20,28,1993,10,female,517,503,159,1121,564,308,220,813,344
1762869,17,20,1996,4,female,127,516,459,1008,527,971,229,37,298
1911739,16,18,1997,10,female,89,514,452,1022,1897,798,1342,224,555
1402105,19,29,1994,11,female,679,510,345,1038,126,1038,84,0,42
1560683,24,3,1989,12,female,345,508,262,1121,310,1121,207,0,103
2062572,23,16,1990,6,female,560,511,158,1045,883,1045,832,0,51
2077135,15,13,1998,12,female,126,507,357,1016,2053,1016,1308,0,745
1255871,20,9,1993,7,female,492,505,375,1160,185,262,64,898,121
1121397,25,14,1988,8,female,336,510,363,1265,1457,1265,1437,0,20
2058560,15,19,1998,4,female,458,518,380,1372,731,726,381,646,350
1570245,18,1,1995,2,female,369,509,320,1305,1435,1144,1039,161,396
2128944,18,6,1995,5,female,647,511,228,1424,872,1362,695,62,177
1125437,15,8,1998,3,male,533,516,338,1515,217,1515,171,0,46
2050576,16,4,1997,11,female,534,506,331,1412,1734,1412,951,0,783
1781327,17,17,1996,3,female,103,503,129,1559,2410,283,1372,1276,1038
1325855,25,31,1988,12,male,57,500,443,1794,1384,752,400,1042,984
2002459,25,8,1988,8,male,502,516,455,1831,144,1603,96,228,48
2111668,15,16,1998,4,female,512,501,323,1851,1935,1684,1050,167,885
1424987,18,13,1995,8,male,259,506,386,2231,1164,262,550,1969,614
1408748,14,1,1999,10,female,282,518,291,2164,1702,0,746,2164,956
1098258,21,16,1992,1,male,418,508,248,2035,987,1456,431,579,556
1779388,26,3,1987,9,female,1528,512,174,2094,944,2006,454,88,490
1462929,16,14,1997,8,female,438,511,441,2441,1321,1734,820,707,501
1416668,23,15,1990,9,female,227,510,388,2622,354,2473,345,149,9
1235613,17,28,1996,12,female,248,502,160,2604,409,2604,111,0,298
1235270,15,24,1998,4,male,89,516,381,6180,1779,1191,1453,4989,326
2114215,18,15,1995,3,male,412,518,262,4952,2907,73,2013,4879,894
1833243,21,5,1992,2,female,318,510,244,4897,1955,3919,1174,978,781
1684286,24,19,1989,10,female,1919,500,400,4174,2929,4088,2854,86,75
1164450,29,11,1984,3,male,384,502,278,6082,10758,5434,9465,648,1293
1842960,25,16,1988,5,female,77,509,54,10674,4440,10674,4280,0,160
1030102,14,14,1999,6,female,460,570,303,104,91,5,14,99,77
2074210,18,12,1995,4,male,272,525,186,103,27,93,18,10,9
1066217,21,7,1992,4,male,582,527,481,101,26,80,21,21,5
1876766,16,22,1997,5,female,384,573,340,102,22,102,11,0,11
1723665,22,16,1991,10,male,572,542,441,103,45,103,43,0,2
1769978,23,30,1990,7,male,226,568,427,107,163,82,116,25,47
1954118,24,5,1989,12,female,764,547,234,105,195,105,156,0,39
1920218,22,7,1991,2,male,583,559,246,113,41,98,41,15,0
1590939,19,31,1994,8,female,461,523,371,112,477,112,436,0,41
1742480,21,6,1992,2,male,324,525,268,117,144,7,38,110,106
2025806,15,2,1998,5,female,289,532,341,116,445,99,326,17,119
2014061,20,16,1993,6,male,488,542,472,117,23,116,13,1,10
1575070,23,25,1990,1,female,173,550,499,115,128,115,118,0,10
1615254,22,24,1991,9,male,300,524,302,120,260,64,125,56,135
1579332,33,21,1980,9,male,424,570,491,120,422,69,266,51,156
1946512,26,7,1987,7,female,1602,568,251,124,129,98,81,26,48
1368372,23,13,1990,6,female,783,547,387,123,466,89,244,34,222
2025911,23,25,1990,10,female,558,554,211,120,323,108,100,12,223
1868143,26,16,1987,4,male,213,529,195,123,139,123,133,0,6
1544588,24,28,1989,9,male,393,549,494,122,282,122,268,0,14
1733942,19,29,1994,1,female,478,519,452,127,240,49,85,78,155
1769244,17,19,1996,4,female,148,549,480,126,17,117,10,9,7
1012915,25,7,1988,10,female,485,571,197,130,222,129,180,1,42
1109042,23,16,1990,9,female,615,552,271,128,132,128,92,0,40
1793123,38,19,1975,5,female,819,547,331,129,187,129,132,0,55
1963358,14,1,1999,1,female,184,550,141,126,284,126,212,0,72
1567230,26,23,1987,2,male,1131,538,279,132,13,130,9,2,4
1025255,17,27,1996,9,female,369,541,356,131,46,103,15,28,31
1912582,15,11,1998,1,female,549,548,390,132,227,132,207,0,20
1750122,25,27,1988,2,female,42,525,277,136,278,136,211,0,67
1649153,17,26,1996,6,female,692,554,231,140,118,9,43,131,75
1314375,16,24,1997,1,male,375,548,380,139,81,89,23,50,58
1980781,16,9,1997,12,female,406,563,291,137,187,37,77,100,110
1741527,24,29,1989,6,female,778,566,385,143,306,63,141,80,165
1026091,20,5,1993,7,male,664,553,262,142,241,142,198,0,43
1401526,26,4,1987,7,male,432,537,470,138,229,138,212,0,17
2110487,37,13,1976,3,male,362,522,449,144,51,23,33,121,18
1657501,14,25,1999,5,female,160,548,241,144,422,134,332,10,90
1313859,22,15,1991,11,female,129,539,102,149,503,149,210,0,293
2004002,20,20,1993,1,male,326,541,378,155,56,0,6,155,50
1582964,17,6,1996,1,male,595,534,94,157,537,19,210,138,327
1083679,23,6,1990,7,female,572,538,400,154,2,58,0,96,2
1097371,23,20,1990,7,male,722,536,381,151,0,127,0,24,0
1827706,18,28,1995,12,male,351,570,411,154,114,154,88,0,26
1236798,20,27,1993,9,male,172,549,369,153,139,153,115,0,24
1830798,18,30,1995,11,female,630,540,395,154,430,154,363,0,67
1356203,19,3,1994,4,male,414,531,464,158,80,122,37,36,43
1324100,32,7,1981,5,female,559,523,279,159,108,150,25,9,83
1968526,34,10,1979,11,female,1506,542,248,161,470,142,293,19,177
2160226,16,5,1997,6,male,257,563,505,158,26,158,13,0,13
1096548,18,24,1995,3,female,293,549,348,159,14,159,12,0,2
1873637,21,23,1992,7,female,1141,542,120,161,293,161,180,0,113
1527497,38,5,1975,1,male,239,547,440,163,333,163,262,0,71
1842459,19,10,1994,9,female,584,537,374,166,184,74,26,92,158
1811960,16,7,1997,3,male,826,520,346,170,23,140,15,30,8
1932867,19,9,1994,5,male,544,560,329,165,656,131,535,34,121
1511791,24,3,1989,3,male,658,569,159,170,619,159,231,11,388
1804338,15,19,1998,6,female,373,524,296,168,52,168,35,0,17
1169562,16,21,1997,3,female,405,520,253,166,95,166,54,0,41
2056173,17,5,1996,11,female,373,539,412,174,33,5,19,169,14
2115626,17,10,1996,5,male,411,553,396,174,38,4,8,170,30
1470756,22,6,1991,2,female,285,534,365,180,317,82,197,98,120
1176785,24,5,1989,3,female,1033,544,313,181,79,132,39,49,40
1732244,19,24,1994,2,male,232,533,363,177,250,157,152,20,98
1556326,23,28,1990,12,female,526,565,234,179,111,177,103,2,8
2053153,22,4,1991,2,male,533,552,182,180,198,171,79,9,119
1058510,23,1,1990,1,male,171,521,486,181,17,181,12,0,5
1141704,26,15,1987,8,female,730,557,435,174,220,174,120,0,100
1036015,42,4,1971,12,male,940,555,261,179,136,179,54,0,82
1411900,22,9,1991,7,male,473,519,339,189,281,108,180,81,101
1835725,18,12,1995,2,female,270,537,479,185,120,161,84,24,36
2048322,17,24,1996,8,female,278,535,51,183,22,183,11,0,11
1358959,18,14,1995,1,male,150,532,463,185,86,185,82,0,4
2085716,20,8,1993,7,female,627,542,154,183,285,183,274,0,11
1265369,22,5,1991,9,male,970,561,134,198,219,0,69,198,150
1387428,21,23,1992,12,male,241,535,363,200,193,67,96,133,97
1714005,21,11,1992,4,female,991,562,267,196,192,48,81,148,111
2109126,19,20,1994,12,female,237,540,377,191,273,179,166,12,107
1783661,19,5,1994,3,female,649,535,333,191,277,168,263,23,14
1043067,14,13,1999,2,female,252,557,325,193,174,193,83,0,91
1390175,24,5,1989,10,female,165,553,491,203,60,112,20,91,40
1285348,18,10,1995,2,male,463,538,252,201,197,201,102,0,95
1677086,33,14,1980,11,male,866,529,436,217,94,47,75,170,19
1430096,16,16,1997,5,male,399,532,305,221,420,62,218,159,202
2105173,22,27,1991,4,female,203,563,427,221,1140,131,582,90,558
1354616,18,2,1995,4,male,532,524,301,212,90,174,64,38,26
1136424,18,16,1995,5,female,526,563,210,217,132,210,89,7,43
1199833,21,21,1992,7,female,968,531,335,215,229,212,184,3,45
1682477,33,8,1980,1,female,155,573,258,215,209,206,162,9,47
1070269,18,1,1995,4,male,279,521,232,221,31,221,25,0,6
1875113,17,16,1996,12,male,101,562,436,217,57,217,21,0,36
1700877,20,9,1993,6,female,285,555,406,213,54,213,44,0,10
1151345,16,10,1997,11,male,42,530,507,215,339,215,238,0,101
1530344,18,14,1995,5,male,225,573,511,228,64,0,28,228,36
1042588,40,18,1973,10,male,893,543,364,230,353,41,143,189,210
1630797,16,17,1997,7,female,663,519,341,224,268,86,157,138,111
1697701,15,18,1998,3,male,272,548,396,232,190,170,38,62,152
1888588,16,3,1997,3,female,152,527,353,229,485,208,174,21,311
1083714,16,12,1997,5,male,530,545,473,226,0,225,0,1,0
1792422,15,30,1998,9,female,319,550,256,240,129,131,33,109,96
1806173,19,30,1994,5,female,808,523,406,237,158,59,66,178,92
1123156,18,30,1995,8,female,236,535,271,236,804,86,525,150,279
2011826,16,12,1997,5,female,610,548,373,236,94,188,29,48,65
1684940,19,17,1994,5,female,583,532,357,237,173,223,150,14,23
1701148,21,3,1992,10,male,203,548,398,242,864,205,794,37,70
1514581,26,21,1987,2,male,543,535,471,245,122,245,83,0,39
2102413,18,9,1995,2,female,538,571,269,242,184,242,117,0,67
1777911,21,11,1992,1,female,471,531,54,246,323,246,178,0,145
1644512,21,15,1992,9,male,567,521,412,249,649,32,44,217,605
1979436,17,20,1996,12,female,690,524,386,256,35,166,26,90,9
1653304,18,7,1995,8,male,564,557,423,256,65,185,31,71,34
1386939,19,23,1994,6,female,1228,560,254,253,172,222,119,31,53
2067300,29,5,1984,9,male,678,524,317,249,282,190,168,59,114
1230289,14,4,1999,4,female,220,548,364,258,433,243,338,15,95
2111757,15,13,1998,10,female,229,546,424,249,901,217,581,32,320
2068114,19,9,1994,3,male,573,549,386,256,77,256,74,0,3
1162860,26,1,1987,1,male,561,569,503,260,92,260,81,0,11
1246434,20,23,1993,1,female,457,569,358,247,283,247,149,0,134
1370317,32,16,1981,3,male,703,548,378,248,325,248,295,0,30
1627165,13,2,2000,1,female,176,551,403,265,492,173,223,92,269
1832548,16,25,1997,8,male,601,526,374,269,186,248,165,21,21
1342664,18,6,1995,10,male,56,527,464,273,476,272,342,1,134
1610858,22,17,1991,8,male,167,538,437,269,100,269,97,0,3
2059475,19,19,1994,2,male,455,546,376,262,463,262,260,0,203
1558158,17,23,1996,12,male,802,565,384,290,139,0,105,290,34
2163365,18,20,1995,7,female,330,561,203,281,139,107,71,174,68
1128900,18,30,1995,7,male,268,521,423,279,156,123,98,156,58
2123575,25,22,1988,8,female,545,524,264,281,235,150,115,131,120
1236032,14,27,1999,7,female,459,536,302,285,324,285,195,0,129
1447141,17,20,1996,11,male,470,553,346,287,218,287,184,0,34
1563857,15,2,1998,4,female,608,559,496,306,67,199,59,107,8
1047011,14,25,1999,1,female,555,543,305,305,263,141,133,164,130
1977768,22,17,1991,1,male,183,560,445,298,267,224,147,74,120
1324555,17,17,1996,10,female,218,537,469,301,548,277,470,24,78
1067304,22,23,1991,10,male,403,561,496,303,192,303,144,0,48
1802722,32,2,1981,4,male,759,519,200,297,440,297,343,0,97
1306276,21,7,1992,1,female,47,556,285,311,204,57,121,254,83
1151983,20,30,1993,10,male,593,529,392,321,100,164,63,157,37
1358060,15,9,1998,10,female,470,536,319,327,204,211,127,116,77
2057581,16,27,1997,10,female,549,548,279,310,234,218,209,92,25
1385644,20,30,1993,5,female,258,555,268,309,449,82,204,227,245
1627318,21,1,1992,6,female,510,560,105,315,612,91,290,224,322
1145927,17,30,1996,6,female,707,544,391,319,117,286,78,33,39
1532574,21,30,1992,1,female,746,560,463,313,122,311,98,2,24
2104903,16,5,1997,4,female,331,562,56,327,509,327,418,0,91
1297141,28,1,1985,3,female,644,521,210,326,969,326,599,0,370
2153012,17,3,1996,1,male,698,559,372,332,60,36,14,296,46
1527633,20,25,1993,5,female,172,541,50,342,127,54,23,288,104
1761080,18,24,1995,4,male,709,542,434,330,50,153,43,177,7
1242646,15,8,1998,8,male,476,530,342,342,375,138,181,204,194
1744711,22,16,1991,12,male,735,535,180,346,768,304,488,42,280
2084547,26,3,1987,3,female,85,541,402,332,689,294,230,38,459
1296729,19,30,1994,12,female,559,519,131,351,1068,40,346,311,722
1629859,17,31,1996,7,male,567,555,460,369,253,106,94,263,159
1928269,23,19,1990,10,female,187,564,506,363,407,275,140,88,267
1401840,33,4,1980,9,female,575,546,446,356,269,265,188,91,81
2096213,20,7,1993,12,male,137,537,451,352,964,308,357,44,607
1200434,21,13,1992,7,female,363,548,476,394,204,26,27,368,177
1033795,17,24,1996,3,female,265,530,428,386,189,115,89,271,100
1538352,21,10,1992,12,female,705,523,245,377,462,236,84,141,378
1065117,31,6,1982,7,female,1619,571,314,390,558,129,239,261,319
1348279,16,10,1997,7,female,380,533,348,373,312,338,112,35,200
2090862,19,26,1994,4,female,306,555,351,388,245,360,121,28,124
1586821,20,2,1993,3,female,466,520,397,392,429,370,264,22,165
1347828,13,21,2000,7,female,357,552,349,390,815,374,550,16,265
1076509,18,19,1995,3,male,607,525,344,394,493,393,194,1,299
1127605,18,3,1995,3,female,316,548,342,379,284,379,248,0,36
1123772,15,26,1998,10,male,559,527,351,410,99,187,48,223,51
1788134,15,21,1998,11,female,925,564,355,410,341,215,99,195,242
1465731,23,12,1990,11,female,940,547,298,396,351,241,167,155,184
1798970,28,17,1985,10,male,964,539,312,400,275,259,132,141,143
1978687,18,27,1995,1,female,283,549,344,395,1246,182,820,213,426
1588459,20,21,1993,2,female,546,569,472,397,204,339,146,58,58
2033835,16,20,1997,1,female,324,559,366,404,299,388,207,16,92
1668944,15,22,1998,6,male,474,565,492,418,146,415,88,3,58
1754294,16,18,1997,11,female,395,570,183,398,244,396,104,2,140
1283203,31,2,1982,4,female,236,553,212,411,926,411,864,0,62
1054000,18,30,1995,3,female,491,535,365,436,295,95,93,341,202
1159724,17,18,1996,11,female,713,528,319,424,903,278,545,146,358
1604013,16,24,1997,6,female,470,550,184,431,858,281,254,150,604
1467565,18,25,1995,7,male,393,553,409,429,1245,166,561,263,684
1030768,24,23,1989,12,female,796,551,376,428,652,100,291,328,361
1106006,14,13,1999,5,female,275,567,312,422,208,373,146,49,62
1905874,18,23,1995,3,male,239,533,374,447,447,352,312,95,135
1823593,19,18,1994,3,female,178,548,442,427,311,413,115,14,196
1950491,15,7,1998,6,female,98,571,293,428,793,389,193,39,600
1618619,20,14,1993,12,male,219,538,469,440,1386,382,1162,58,224
1617569,14,25,1999,7,female,408,532,424,442,53,440,24,2,29
1360667,41,15,1972,2,female,693,567,301,423,803,420,387,3,416
1680230,19,12,1994,5,male,375,567,451,431,328,431,315,0,13
2108675,18,23,1995,11,female,351,560,297,439,990,439,788,0,202
1983446,17,5,1996,3,male,604,536,378,479,305,250,129,229,176
1203596,34,3,1979,9,female,796,566,99,469,665,262,197,207,468
1871809,26,13,1987,8,female,188,570,448,458,247,458,222,0,25
2003551,27,9,1986,12,female,693,537,359,454,402,454,207,0,195
1634110,23,22,1990,12,male,274,557,299,459,749,459,650,0,99
2016176,20,19,1993,12,male,857,567,353,508,228,245,135,263,93
1220723,19,12,1994,7,male,624,571,278,511,207,153,107,358,100
1150658,18,6,1995,10,female,366,566,142,500,422,238,80,262,342
1171922,24,17,1989,12,female,808,530,225,491,492,205,195,286,297
2100005,15,3,1998,8,female,522,559,226,502,1348,123,248,379,1100
2036805,24,28,1989,8,female,211,540,436,490,555,468,388,22,167
1845141,41,16,1972,9,female,1607,549,131,500,231,499,126,1,105
1446422,16,10,1997,4,male,397,561,336,515,185,515,143,0,42
1300012,21,16,1992,7,male,187,550,474,485,503,485,441,0,62
1196740,25,19,1988,9,female,176,562,464,494,442,494,391,0,51
1877803,16,24,1997,10,female,175,558,410,556,718,68,244,488,474
1104970,14,31,1999,1,female,41,531,410,547,540,299,212,248,328
1023709,20,8,1993,10,male,1362,538,292,524,350,231,266,293,84
2095612,32,15,1981,5,female,1321,541,303,560,723,183,230,377,493
1746305,20,14,1993,8,female,795,566,336,525,892,301,409,224,483
1894697,15,15,1998,11,male,541,557,413,546,323,524,123,22,200
1798724,19,15,1994,2,male,659,568,259,531,474,524,293,7,181
1687509,23,20,1990,5,female,284,528,478,552,749,491,649,61,100
1682022,13,23,2000,3,male,153,539,430,546,186,546,158,0,28
1330734,22,5,1991,6,male,798,567,460,537,349,537,316,0,33
2184455,30,29,1983,8,female,632,565,308,559,500,559,381,0,119
1264049,16,25,1997,11,female,626,572,401,578,542,34,216,544,326
2087962,40,10,1973,7,female,283,528,352,569,569,15,206,554,363
1372643,20,5,1993,1,male,307,534,473,579,480,141,194,438,286
1014064,25,18,1988,8,female,504,532,331,562,535,265,217,297,318
2154645,26,27,1987,12,male,1393,523,279,574,1102,303,965,271,137
1717710,17,5,1996,10,male,494,531,420,601,574,508,507,93,67
1947947,14,14,1999,5,female,272,528,255,583,128,583,117,0,11
1593001,18,28,1995,6,male,710,524,361,572,573,572,297,0,276
1072158,13,13,2000,1,female,579,572,418,649,934,1,87,648,847
1388560,15,14,1998,12,female,372,522,360,647,481,60,147,587,334
2039163,15,10,1998,5,female,34,566,533,639,157,174,51,465,106
1211645,23,30,1990,7,female,585,554,218,646,541,447,211,199,330
1815226,18,17,1995,8,female,516,540,353,647,1062,446,529,201,533
1344853,39,10,1974,6,female,1425,519,246,648,1048,211,443,437,605
1517869,18,24,1995,7,male,336,533,280,654,845,623,336,31,509
1979780,32,13,1981,11,male,560,527,433,653,569,503,130,150,439
1815638,20,24,1993,6,male,706,556,456,655,404,654,367,1,37
1204874,23,11,1990,5,male,232,558,520,654,51,654,36,0,15
1713212,19,7,1994,5,female,335,544,133,631,149,631,89,0,60
2086245,19,7,1994,11,male,256,561,497,660,527,660,464,0,63
1366359,22,26,1991,8,female,435,531,159,662,498,662,433,0,65
1437977,25,9,1988,10,female,341,543,445,627,1043,627,880,0,163
1585405,22,24,1991,4,male,855,537,345,725,1012,270,777,455,235
1165867,21,21,1992,11,male,333,563,340,725,390,656,226,69,164
1258113,21,15,1992,8,female,485,573,415,711,183,694,102,17,81
1458834,16,20,1997,9,female,256,566,388,721,998,538,524,183,474
1406067,18,19,1995,6,female,264,549,450,715,1620,685,959,30,661
1550540,20,21,1993,8,female,686,523,402,712,27,711,12,1,15
1143405,25,8,1988,6,male,271,535,353,716,572,716,531,0,41
1748853,39,27,1974,11,female,699,532,404,671,621,671,509,0,112
1399753,20,21,1993,7,female,85,543,461,703,1824,703,1463,0,361
1598445,20,7,1993,9,female,922,564,242,733,401,261,184,472,217
1239098,25,22,1988,12,female,2065,567,236,752,817,528,462,224,355
1114387,15,22,1998,10,female,562,557,493,743,216,720,174,23,42
1057523,20,22,1993,6,female,1545,542,229,795,1066,742,983,53,83
1651476,19,10,1994,6,female,731,550,390,733,601,729,491,4,110
2191779,16,16,1997,5,female,171,551,334,729,58,729,49,0,9
2040816,20,8,1993,11,male,518,567,496,784,241,784,169,0,72
1948490,23,8,1990,11,female,309,529,159,738,1755,738,1666,0,89
1381363,16,31,1997,7,male,207,553,291,854,356,570,223,284,133
1481316,18,24,1995,11,female,723,526,367,808,790,352,264,456,526
1123175,18,29,1995,11,female,274,538,212,812,902,469,623,343,279
1269874,17,22,1996,1,male,241,558,334,803,1003,298,688,505,315
1664920,20,4,1993,3,female,258,569,343,804,526,360,304,444,222
1634779,22,14,1991,1,female,1387,521,149,867,869,576,659,291,210
2168063,23,22,1990,6,female,888,559,378,829,1066,516,545,313,521
1806789,19,3,1994,10,female,323,563,277,816,3137,466,819,350,2318
1896796,20,2,1993,2,female,295,550,286,851,1323,611,666,240,657
1882273,19,27,1994,4,female,384,563,147,873,215,873,160,0,55
2164573,15,15,1998,5,female,120,551,484,860,722,860,703,0,19
1459690,15,4,1998,6,female,310,537,101,869,586,869,476,0,110
1500486,19,16,1994,2,female,313,524,449,806,797,806,570,0,227
1645162,15,30,1998,7,female,326,546,365,874,1461,874,1319,0,142
1350501,20,13,1993,1,female,515,563,243,848,2798,848,2156,0,642
1987946,25,10,1988,2,female,377,538,185,816,1268,816,1198,0,70
1798781,16,13,1997,6,male,192,521,383,986,107,705,69,281,38
1119486,24,21,1989,1,female,599,564,322,906,433,583,263,323,170
1285781,15,14,1998,7,male,109,554,485,978,1478,441,646,537,832
2111876,19,24,1994,4,female,536,551,310,918,328,666,228,252,100
1882160,29,17,1984,1,male,512,569,412,919,859,911,641,8,218
1788575,20,1,1993,1,male,216,564,508,913,370,913,331,0,39
1474769,21,8,1992,9,male,761,572,191,959,285,959,247,0,38
1010010,21,22,1992,2,female,506,555,305,946,679,946,401,0,278
1835592,25,28,1988,12,female,650,548,292,967,1137,967,1058,0,79
1035533,20,7,1993,3,female,103,528,129,1101,1708,0,381,1101,1327
1405711,17,8,1996,6,female,605,562,424,1128,176,714,46,414,130
1596004,16,15,1997,10,male,416,553,393,1068,510,709,141,359,369
1934217,24,1,1989,11,female,1381,549,359,1000,551,709,394,291,157
1237071,26,3,1987,9,female,1661,558,243,1042,231,268,65,774,166
1286400,14,20,1999,8,female,392,527,105,1005,543,904,388,101,155
1150712,15,16,1998,8,female,1337,555,198,1053,722,1030,607,23,115
1066474,25,10,1988,6,female,686,548,391,1111,757,852,373,259,384
1519931,15,16,1998,7,female,233,520,140,1128,2391,973,1222,155,1169
1687469,20,10,1993,8,female,519,546,180,1056,633,1056,404,0,229
1239544,14,21,1999,6,male,181,550,457,1237,317,0,58,1237,259
1579747,14,5,1999,9,female,343,553,407,1147,805,71,405,1076,400
1660982,18,21,1995,10,female,688,553,262,1203,862,80,421,1123,441
2152531,23,6,1990,11,female,1853,519,324,1177,1542,88,589,1089,953
1185247,15,8,1998,6,female,523,564,429,1163,956,448,271,715,685
1323712,24,17,1989,7,female,400,571,362,1184,1138,466,756,718,382
1938318,27,1,1986,8,male,755,537,340,1182,351,1153,94,29,257
1971740,20,22,1993,4,female,862,522,303,1276,1463,1233,822,43,641
2089537,22,13,1991,4,female,357,554,384,1192,1563,1179,1432,13,131
1778147,17,17,1996,1,female,626,541,219,1168,1453,1168,1321,0,132
2000521,23,1,1990,1,male,394,553,453,1421,281,24,210,1397,71
1790575,16,6,1997,1,male,817,532,264,1303,1453,220,288,1083,1165
2103853,23,26,1990,10,female,804,557,488,1515,2021,157,1360,1358,661
1580783,24,10,1989,2,male,1451,520,375,1331,585,590,119,741,466
1082871,14,4,1999,8,female,866,569,409,1395,318,1215,233,180,85
1770533,16,25,1997,3,female,397,522,323,1500,373,1461,220,39,153
1088456,18,9,1995,4,male,457,550,459,1506,476,1291,427,215,49
1294765,16,8,1997,2,female,484,526,374,1332,452,1331,151,1,301
1653152,23,27,1990,1,female,844,557,132,1326,940,1326,900,0,40
1390519,25,14,1988,2,male,673,562,433,1301,1095,1301,918,0,177
1167532,19,17,1994,10,female,546,533,374,1609,895,242,200,1367,695
1700831,25,8,1988,9,female,814,550,285,1868,2676,674,1319,1194,1357
1935681,39,14,1974,12,female,998,526,157,1790,4135,449,1504,1341,2631
1764304,16,15,1997,11,male,571,549,234,1648,610,1606,500,42,110
1575927,28,31,1985,3,female,519,573,361,1717,823,1683,543,34,280
1040708,22,16,1991,8,female,672,565,394,1636,2429,1580,2284,56,145
1239074,35,1,1978,10,male,108,521,438,1545,1203,1400,664,145,539
2117173,23,18,1990,9,male,537,550,486,1528,21,1528,17,0,4
1494446,33,18,1980,10,female,301,558,513,1679,285,1679,212,0,73
1180270,24,26,1989,2,female,419,536,205,1671,1108,1671,936,0,172
1522711,17,8,1996,1,female,163,526,369,2016,817,42,554,1974,263
1749233,19,25,1994,11,female,658,569,363,2132,1147,0,777,2132,370
1739422,32,17,1981,5,female,768,555,133,2307,1281,149,428,2158,853
1586157,19,16,1994,8,female,235,557,253,2023,746,1324,363,699,383
2046105,14,8,1999,9,female,445,529,263,2063,1787,791,1102,1272,685
1580551,18,8,1995,6,female,469,538,419,2023,2629,637,1834,1386,795
1914686,15,10,1998,8,female,280,529,341,2172,1227,1587,510,585,717
2013219,21,16,1992,12,female,1305,537,310,2237,469,2208,362,29,107
1124124,15,11,1998,1,male,184,557,406,2288,2071,1887,1883,401,188
1623118,34,26,1979,8,male,1280,530,155,2026,2623,1895,1462,131,1161
1701871,42,24,1971,7,female,560,561,226,2081,267,2081,140,0,127
1650012,22,12,1991,12,male,709,573,490,2197,2057,2197,1981,0,76
1442272,15,8,1998,6,male,189,547,440,2944,1376,299,500,2645,876
2154985,17,17,1996,2,female,270,524,419,2477,1122,44,485,2433,637
1701804,19,3,1994,3,female,624,565,433,2925,1115,1863,693,1062,422
1643884,14,30,1999,6,female,1070,543,298,3503,1306,2994,760,509,546
1057185,42,10,1971,10,female,1034,539,236,2850,2630,2797,1244,53,1386
1593253,19,14,1994,1,female,312,552,373,2765,4393,2696,2151,69,2242
1369573,39,24,1974,11,female,583,539,404,2497,1517,2497,1216,0,301
1105585,18,14,1995,10,female,701,568,399,2471,1891,2471,794,0,1097
1605614,20,9,1993,5,male,374,542,367,3087,1919,3087,1632,0,287
1038359,23,1,1990,2,female,769,573,402,3931,2620,336,471,3595,2149
1275323,17,19,1996,7,female,467,522,285,4728,715,4313,418,415,297
1372868,16,3,1997,2,female,648,545,307,3612,982,3142,320,470,662
1320732,25,11,1988,5,male,196,543,320,10498,2910,7701,1601,2797,1309
1697304,26,14,1987,4,female,527,524,362,7083,3698,5913,1830,1170,1868
1745507,18,24,1995,9,female,192,530,275,3799,3977,3539,1603,260,2374
2064754,18,12,1995,5,female,309,521,313,3968,1725,3953,1405,15,320
1375917,24,9,1989,8,male,435,527,340,4058,661,4058,583,0,78
1993980,29,15,1984,1,male,251,521,406,6612,369,6612,334,0,35
1943692,13,14,2000,1,female,243,556,209,9446,5344,9446,4945,0,399
2099884,25,10,1988,1,female,171,555,61,3876,1769,3876,1428,0,341
2025325,33,1,1980,8,male,47,525,506,6119,1439,6119,1323,0,116
1359381,25,4,1988,4,female,99,547,316,4005,5513,4005,3167,0,2346
1086332,16,25,1997,9,female,673,574,378,104,232,54,148,50,84
1426368,21,5,1992,10,male,1380,635,329,101,58,83,46,18,12
1328028,15,25,1998,9,female,192,585,96,103,164,90,123,13,41
1915027,34,17,1979,2,female,1264,628,293,103,268,101,197,2,71
1469929,16,2,1997,1,female,358,605,379,107,439,21,227,86,212
1060000,20,30,1993,4,male,266,630,590,109,77,51,58,58,19
1644582,22,6,1991,12,female,1062,592,171,105,259,74,141,31,118
1501390,15,4,1998,10,male,398,626,299,105,165,88,134,17,31
1523239,19,29,1994,9,female,461,585,300,105,138,105,75,0,63
1228835,28,18,1985,6,female,442,605,469,108,131,108,126,0,5
1460197,16,13,1997,11,male,1076,588,255,110,40,3,26,107,14
1017904,18,11,1995,11,female,409,630,506,113,54,30,21,83,33
1028493,22,26,1991,3,male,1675,604,383,110,363,69,315,41,48
1359911,40,20,1973,6,female,1958,608,337,112,69,96,23,16,46
2057226,15,18,1998,2,male,382,639,548,112,50,112,29,0,21
1499486,18,26,1995,2,male,274,574,319,111,75,111,52,0,23
1296665,17,15,1996,9,female,425,627,119,112,209,112,203,0,6
1437931,16,27,1997,8,male,270,609,417,116,3,0,1,116,2
2184424,23,31,1990,7,male,1159,597,284,118,40,5,19,113,21
1881961,14,18,1999,8,male,497,639,489,119,127,1,59,118,68
2100710,16,7,1997,4,female,617,616,334,119,74,1,15,118,59
1861852,22,7,1991,8,male,640,591,415,116,267,22,181,94,86
1971135,20,18,1993,5,female,308,592,273,115,30,90,18,25,12
1207825,20,13,1993,6,male,464,596,468,115,71,115,68,0,3
1623755,27,4,1986,4,female,920,579,267,123,691,87,647,36,44
1841751,29,14,1984,9,female,1546,609,505,121,240,117,156,4,84
1087766,26,10,1987,5,male,543,574,460,124,42,124,32,0,10
2033934,21,4,1992,10,female,1101,576,371,123,213,123,144,0,69
1567362,22,16,1991,7,female,92,620,532,121,493,121,463,0,30
2147376,21,2,1992,8,female,284,620,327,127,298,83,198,44,100
2012461,25,9,1988,12,female,309,621,270,125,194,44,80,81,114
1619468,25,6,1988,10,female,158,627,547,128,283,43,168,85,115
2181913,15,24,1998,5,female,84,624,523,125,183,124,102,1,81
1790926,15,6,1998,6,female,333,594,393,126,52,126,48,0,4
1850876,16,23,1997,7,female,262,626,467,130,84,130,63,0,21
1320030,19,16,1994,5,male,683,621,474,129,87,129,74,0,13
1847177,21,25,1992,12,female,422,581,104,125,113,125,99,0,14
1037611,21,4,1992,6,female,1524,633,276,132,113,92,89,40,24
1235261,18,20,1995,8,male,203,583,419,134,130,130,123,4,7
1290770,16,16,1997,4,female,435,633,386,131,38,131,22,0,16
1772714,17,27,1996,7,female,390,616,445,134,63,134,50,0,13
2154033,19,5,1994,10,male,175,613,455,143,15,0,1,143,14
1891722,19,27,1994,1,female,602,616,354,142,75,106,40,36,35
1350720,23,6,1990,12,female,614,595,227,141,55,114,19,27,36
1082316,20,21,1993,3,female,373,589,278,142,188,135,117,7,71
1734252,24,27,1989,10,female,1193,615,332,139,173,110,116,29,57
1505660,23,24,1990,8,male,1869,581,253,139,239,136,183,3,56
1864147,21,23,1992,8,female,267,633,136,140,14,140,13,0,1
2073328,29,14,1984,4,female,747,620,310,139,35,139,26,0,9
1978432,26,10,1987,6,female,334,574,123,139,187,139,116,0,71
1350689,24,15,1989,4,male,374,624,549,143,364,143,282,0,82
1588457,19,8,1994,5,male,455,596,504,144,25,34,16,110,9
1544496,21,10,1992,5,female,491,612,549,148,363,44,173,104,190
1170756,23,9,1990,4,male,669,623,456,147,482,95,247,52,235
1456149,30,2,1983,10,male,651,632,155,145,604,73,304,72,300
1381621,18,7,1995,8,male,654,612,464,144,51,133,38,11,13
1553439,19,2,1994,1,female,387,580,136,148,380,128,170,20,210
1158635,24,16,1989,10,male,736,578,481,144,132,144,127,0,5
1691147,15,20,1998,4,female,375,627,289,156,82,36,42,120,40
1278272,16,9,1997,5,female,128,621,251,157,207,109,120,48,87
1123861,18,22,1995,8,female,284,629,432,155,142,104,105,51,37
1792604,25,13,1988,4,female,1563,579,284,157,155,37,105,120,50
2147697,15,20,1998,1,female,221,629,366,152,439,34,132,118,307
1860999,19,12,1994,10,female,548,595,290,153,126,119,83,34,43
1204197,16,8,1997,2,male,567,616,364,152,410,113,308,39,102
1089347,18,27,1995,7,female,155,635,316,152,249,149,112,3,137
1672322,23,15,1990,5,male,882,626,521,156,8,156,8,0,0
1994544,16,16,1997,6,male,237,628,472,157,64,157,41,0,23
1213678,24,23,1989,11,male,310,636,568,156,114,156,110,0,4
1230362,23,10,1990,5,female,228,616,382,159,132,128,80,31,52
1506290,14,5,1999,2,male,313,587,531,162,593,148,539,14,54
1452308,20,3,1993,9,male,282,621,505,166,93,47,82,119,11
1508346,17,2,1996,2,male,672,603,458,169,188,95,89,74,99
1793042,41,23,1972,7,female,267,605,377,172,181,68,45,104,136
2029016,24,23,1989,10,female,1443,595,284,165,81,164,68,1,13
1135231,20,24,1993,8,female,309,630,338,165,376,164,316,1,60
2174341,16,28,1997,7,female,487,605,394,168,84,168,56,0,28
2000274,23,9,1990,2,male,866,595,281,174,95,107,76,67,19
2063513,35,15,1978,6,female,1443,635,427,180,136,178,85,2,51
2132226,19,25,1994,8,female,164,614,37,180,276,180,217,0,59
1216914,27,21,1986,4,female,1764,629,414,178,685,178,618,0,67
1977703,22,25,1991,10,male,492,587,515,184,105,52,65,132,40
1892557,27,13,1986,3,male,381,610,380,190,103,75,44,115,59
1673911,19,28,1994,7,male,309,598,203,187,217,81,147,106,70
1196009,17,10,1996,4,male,520,598,483,190,70,151,42,39,28
1594332,30,16,1983,10,male,1363,610,392,183,38,183,33,0,5
2119524,17,28,1996,10,female,258,611,374,184,192,184,100,0,92
1143318,18,20,1995,2,female,595,595,239,185,192,185,110,0,82
1423878,42,25,1971,8,female,1461,620,220,184,336,184,200,0,136
1406821,22,9,1991,6,male,395,602,427,194,648,8,454,186,194
2153833,16,24,1997,5,female,182,577,440,194,120,111,99,83,21
1972784,16,15,1997,10,male,465,616,359,192,154,132,96,60,58
1589769,25,2,1988,12,female,363,586,488,191,147,131,63,60,84
2162801,16,10,1997,12,female,348,593,92,194,341,132,127,62,214
1508687,15,13,1998,10,female,56,598,317,193,311,130,243,63,68
1192148,27,5,1986,3,male,1688,637,253,195,320,111,267,84,53
2114847,23,27,1990,4,female,522,611,366,200,238,195,120,5,118
1028279,15,25,1998,11,female,221,597,320,196,138,196,93,0,45
1359003,19,4,1994,1,female,203,624,194,192,132,192,112,0,20
1837787,21,19,1992,10,male,317,607,538,196,747,196,691,0,56
2158975,15,4,1998,3,female,296,595,282,209,61,41,20,168,41
1035309,20,23,1993,7,female,187,635,477,201,230,33,129,168,101
2124284,25,12,1988,8,female,668,586,350,204,623,135,444,69,179
1314984,22,18,1991,3,female,902,626,191,210,277,192,67,18,210
2132908,24,22,1989,11,female,771,603,393,205,430,203,303,2,127
1557315,29,21,1984,4,male,483,619,548,203,58,203,55,0,3
1115453,19,27,1994,5,male,284,613,343,211,681,211,468,0,213
1635723,32,13,1981,4,male,1820,580,228,220,153,16,93,204,60
1872590,16,8,1997,6,male,386,606,445,219,92,155,42,64,50
1000602,26,7,1987,9,male,631,622,411,213,213,129,119,84,94
1156075,20,27,1993,7,female,1056,576,205,218,519,132,415,86,104
1372784,15,10,1998,10,male,334,586,435,212,158,197,86,15,72
1265994,17,7,1996,10,male,130,639,297,216,480,206,387,10,93
1181215,20,8,1993,7,male,141,582,492,213,390,175,296,38,94
1141042,18,11,1995,11,female,531,621,458,221,353,221,179,0,174
1216850,19,5,1994,2,female,567,597,369,215,407,215,397,0,10
1337058,39,19,1974,11,female,464,589,282,221,533,221,482,0,51
1965113,16,16,1997,5,male,543,575,342,222,29,41,19,181,10
1068780,17,4,1996,2,female,354,627,320,227,231,122,142,105,89
1761861,15,23,1998,4,female,96,587,267,231,356,86,192,145,164
1887325,21,20,1992,7,female,111,576,492,228,295,228,209,0,86
1623506,28,29,1985,10,male,1285,635,465,226,138,226,119,0,19
1974837,18,2,1995,9,female,51,590,228,226,376,226,274,0,102
1700905,18,26,1995,6,female,892,601,556,243,119,9,33,234,86
2055898,18,11,1995,9,female,1040,584,454,234,104,0,36,234,68
2039892,24,11,1989,1,female,1817,635,225,245,340,13,168,232,172
1247133,16,8,1997,10,female,443,609,427,235,104,129,68,106,36
1742621,17,23,1996,6,female,1056,624,349,237,404,125,205,112,199
1414527,16,28,1997,8,female,543,625,386,242,211,228,156,14,55
1639197,17,10,1996,3,male,111,593,538,238,245,210,190,28,55
1231562,18,18,1995,9,male,968,597,314,243,29,243,25,0,4
1913174,28,4,1985,3,female,1454,613,172,246,1149,246,1108,0,41
1191326,19,9,1994,7,male,713,585,389,253,259,152,23,101,236
1077124,22,19,1991,11,female,455,639,285,253,572,244,223,9,349
1593201,18,9,1995,11,male,183,629,182,258,227,256,101,2,126
1941792,19,1,1994,5,male,729,582,130,248,240,247,172,1,68
1826265,24,30,1989,4,male,523,622,421,269,391,140,163,129,228
1539001,17,18,1996,2,male,259,605,493,262,489,143,299,119,190
2163126,18,19,1995,10,female,491,582,276,265,221,223,85,42,136
1061609,18,13,1995,5,female,328,596,463,274,826,222,305,52,521
1600890,19,14,1994,12,male,644,601,497,261,98,261,67,0,31
1387333,16,9,1997,8,female,385,574,450,283,55,49,25,234,30
1012816,15,23,1998,8,male,279,634,388,281,90,141,46,140,44
1345240,17,22,1996,8,female,1408,586,347,288,282,205,166,83,116
2086288,29,9,1984,11,male,644,576,451,279,299,92,61,187,238
1411710,22,15,1991,4,male,380,601,396,281,455,158,306,123,149
2183259,16,27,1997,1,female,552,627,334,286,295,268,88,18,207
1882529,22,7,1991,6,male,308,579,374,282,183,217,107,65,76
1524730,26,1,1987,1,male,354,593,341,281,465,251,350,30,115
1757295,19,25,1994,9,male,544,600,273,286,157,286,75,0,82
1127510,29,14,1984,2,female,113,579,97,292,57,292,52,0,5
1623050,20,23,1993,8,female,1620,581,233,306,202,191,119,115,83
2142022,20,17,1993,4,female,574,631,369,300,321,300,186,0,135
1651847,21,28,1992,7,male,441,579,516,312,240,48,143,264,97
2017786,22,10,1991,10,female,739,592,335,318,733,50,140,268,593
1706157,26,6,1987,9,female,1032,577,162,313,146,286,78,27,68
1160706,15,27,1998,1,male,303,578,336,309,197,268,147,41,50
1821442,19,3,1994,1,female,342,636,341,322,452,257,131,65,321
1894246,16,17,1997,3,female,795,622,122,317,562,296,310,21,252
2049993,18,12,1995,2,female,578,611,228,318,198,318,168,0,30
2036734,17,14,1996,12,female,574,617,331,337,309,54,67,283,242
1872612,22,24,1991,10,female,504,620,154,331,297,7,129,324,168
1370152,21,28,1992,10,female,398,589,110,328,404,199,259,129,145
1566949,20,5,1993,10,male,569,609,284,330,1029,150,510,180,519
1033046,15,31,1998,8,female,503,591,331,343,408,333,127,10,281
1496442,19,23,1994,7,female,541,597,404,337,476,303,293,34,183
1288312,18,2,1995,11,female,523,603,408,330,765,315,643,15,122
1040006,24,9,1989,3,female,530,634,475,342,190,342,71,0,119
1262454,18,5,1995,8,female,635,637,333,346,298,346,189,0,109
1347180,20,15,1993,6,male,440,584,541,338,206,338,183,0,23
1296809,20,31,1993,8,female,427,576,69,339,647,339,595,0,52
2061094,17,31,1996,10,female,529,619,239,355,451,256,340,99,111
1327800,17,31,1996,10,male,357,602,471,350,979,102,558,248,421
1717061,14,1,1999,1,female,265,588,285,351,298,336,177,15,121
1495071,18,21,1995,8,female,527,608,308,365,354,362,180,3,174
1100152,16,7,1997,6,male,436,585,432,367,185,367,164,0,21
1403056,18,27,1995,9,male,730,579,407,368,155,368,120,0,35
1910094,20,28,1993,9,male,433,582,464,368,141,368,129,0,12
1863000,15,19,1998,2,female,437,627,445,368,391,368,320,0,71
2141146,17,21,1996,4,female,171,602,336,357,277,357,140,0,137
2051407,17,28,1996,1,male,720,630,392,377,220,206,118,171,102
1108162,14,12,1999,7,female,311,593,169,373,313,138,236,235,77
1765290,25,23,1988,1,female,946,601,387,390,510,87,127,303,383
1922607,21,7,1992,10,female,864,595,169,389,188,370,70,19,118
1184535,16,27,1997,12,male,654,577,173,394,400,394,114,0,286
1042845,16,14,1997,4,female,348,605,213,374,486,374,396,0,90
1621485,21,20,1992,5,female,629,612,402,389,485,389,451,0,34
2140007,30,21,1983,5,female,796,595,262,387,348,387,265,0,83
2065515,32,1,1981,10,female,525,575,298,385,868,385,495,0,373
1095533,18,13,1995,12,male,629,604,289,409,395,17,160,392,235
1377269,17,27,1996,5,male,384,623,519,396,538,73,443,323,95
1713185,19,31,1994,5,female,1042,592,350,403,356,35,291,368,65
2123763,16,23,1997,9,female,27,615,432,402,980,55,365,347,615
1341681,28,19,1985,12,male,1655,626,287,418,472,181,384,237,88
1204057,18,23,1995,6,female,412,612,360,418,1008,239,452,179,556
1639384,33,21,1980,6,male,1360,586,392,413,1353,84,1179,329,174
1687270,18,30,1995,5,female,1137,580,317,402,37,376,9,26,28
1252344,30,20,1983,7,male,417,621,483,402,217,342,66,60,151
1566583,17,30,1996,4,male,630,624,516,418,62,418,17,0,45
1423527,17,28,1996,4,male,345,613,568,395,98,395,94,0,4
1454672,21,9,1992,6,male,264,603,261,415,136,415,76,0,60
2100574,17,25,1996,9,male,275,628,401,396,334,396,270,0,64
1422391,14,19,1999,1,female,400,583,417,442,115,135,21,307,94
1302898,19,22,1994,9,female,219,580,313,432,544,143,309,289,235
2022839,30,23,1983,2,female,732,591,257,440,459,316,264,124,195
1492546,24,6,1989,5,male,1421,637,488,441,103,435,94,6,9
1213840,15,17,1998,5,female,511,625,250,446,501,402,189,44,312
1995545,20,26,1993,3,female,800,577,137,432,541,398,275,34,266
2143980,18,22,1995,9,female,380,607,198,437,838,419,404,18,434
1137542,23,14,1990,12,male,212,624,435,438,375,438,362,0,13
1684538,26,23,1987,6,female,789,621,307,422,924,422,794,0,130
1164325,15,12,1998,9,female,575,607,312,452,103,53,33,399,70
2081890,16,21,1997,7,male,783,595,344,473,211,143,68,330,143
2020993,17,15,1996,3,female,742,582,339,472,496,106,250,366,246
1009651,22,16,1991,11,female,355,602,328,476,321,134,141,342,180
2097166,31,22,1982,5,female,2152,620,360,469,752,188,306,281,446
1864437,14,15,1999,9,male,560,630,450,468,264,431,237,37,27
1101254,18,29,1995,11,female,1370,618,251,479,251,462,97,17,154
1838231,18,6,1995,2,female,398,584,319,476,1106,390,369,86,737
1870056,20,2,1993,6,female,676,591,408,458,1001,454,599,4,402
1943625,19,17,1994,2,female,357,596,282,474,533,474,250,0,283
1263165,21,6,1992,6,female,352,584,396,481,456,481,378,0,78
1372334,23,18,1990,8,male,557,626,530,455,287,455,282,0,5
1110524,33,12,1980,5,male,608,590,380,452,363,452,307,0,56
1102266,15,9,1998,3,female,116,581,325,506,324,282,120,224,204
1629584,18,20,1995,12,female,514,575,363,507,551,255,101,252,450
1138762,25,11,1988,7,male,379,611,75,514,477,502,344,12,133
1364886,20,1,1993,1,male,505,613,510,514,70,514,62,0,8
1695303,25,26,1988,10,female,411,592,183,507,713,507,577,0,136
2114407,27,21,1986,10,female,441,633,524,500,346,500,202,0,144
1975936,18,8,1995,5,female,28,614,32,485,830,485,686,0,144
1625782,19,8,1994,4,female,1119,606,384,553,410,167,111,386,299
1339048,19,11,1994,1,female,945,580,217,530,448,424,244,106,204
2076611,14,21,1999,11,female,444,591,402,525,841,507,462,18,379
1890574,25,18,1988,5,female,443,583,268,549,1797,472,926,77,871
1188438,21,17,1992,7,female,632,601,394,538,419,537,380,1,39
1074872,29,11,1984,4,female,1396,605,179,529,979,524,873,5,106
1869130,18,19,1995,10,male,366,622,457,520,292,520,241,0,51
1471128,19,28,1994,5,male,502,615,434,529,946,529,834,0,112
1517681,15,14,1998,6,female,321,610,462,567,284,68,199,499,85
2122485,19,12,1994,11,male,379,630,485,584,472,33,291,551,181
2007117,21,10,1992,3,female,389,595,265,588,1053,127,255,461,798
1235962,16,18,1997,10,female,783,589,240,608,672,560,440,48,232
1522347,17,8,1996,8,female,419,605,277,598,709,458,295,140,414
1263328,25,23,1988,5,female,1102,632,380,582,421,463,102,119,319
1966251,18,12,1995,3,female,578,607,451,594,1320,584,1120,10,200
1892004,16,10,1997,7,female,435,621,272,571,367,570,312,1,55
1902127,17,1,1996,1,male,85,576,547,576,394,576,149,0,245
1559579,18,15,1995,3,male,602,615,372,563,641,563,587,0,54
2121965,17,24,1996,6,female,197,599,529,602,1125,602,925,0,200
1454860,16,15,1997,9,female,250,584,466,631,291,283,172,348,119
1967816,19,22,1994,5,male,809,602,91,651,282,359,265,292,17
1775925,16,9,1997,4,male,427,634,483,629,475,244,190,385,285
1615998,16,5,1997,5,female,236,613,536,649,865,347,640,302,225
1510190,25,6,1988,2,female,484,580,126,661,687,300,552,361,135
1132966,14,21,1999,4,male,307,628,398,652,1092,409,374,243,718
1218708,19,19,1994,8,female,418,604,416,610,102,561,74,49,28
1151722,18,15,1995,4,female,894,584,337,635,676,525,217,110,459
1266704,18,23,1995,8,female,422,584,265,615,775,575,667,40,108
1342169,20,7,1993,10,female,434,630,468,648,1634,641,846,7,788
1022476,21,25,1992,11,female,709,590,434,649,303,649,254,0,49
1685858,17,13,1996,5,female,1379,583,401,712,2560,44,601,668,1959
1511449,15,10,1998,1,female,518,600,222,702,617,269,365,433,252
1412737,20,30,1993,11,female,353,629,398,725,469,360,262,365,207
1481553,19,15,1994,6,female,195,612,402,669,432,192,156,477,276
1206405,19,23,1994,9,male,383,597,381,669,470,261,234,408,236
1199991,22,11,1991,10,female,1256,596,139,710,737,179,507,531,230
1068611,16,24,1997,4,female,539,638,511,704,404,685,343,19,61
1408780,16,13,1997,2,female,698,609,214,716,1084,527,753,189,331
1305633,26,2,1987,7,male,102,605,566,699,170,693,133,6,37
2103631,36,16,1977,8,female,1701,625,327,716,288,715,205,1,83
2126474,25,13,1988,1,male,774,603,468,712,947,708,810,4,137
1067234,17,27,1996,7,female,218,614,451,741,417,316,197,425,220
1943849,19,28,1994,5,female,749,595,326,759,943,407,161,352,782
1489988,23,27,1990,8,female,1572,629,215,784,1087,684,885,100,202
1493379,34,5,1979,8,female,911,634,356,785,994,622,524,163,470
1034283,18,13,1995,12,female,326,627,399,755,1762,672,1008,83,754
1464691,18,11,1995,2,male,1047,605,328,793,361,790,178,3,183
1999189,20,6,1993,5,female,364,627,468,763,178,763,153,0,25
1635788,21,29,1992,6,male,248,608,489,790,305,790,244,0,61
1803200,33,5,1980,8,female,1220,597,236,793,637,793,441,0,196
1575556,19,9,1994,12,male,105,589,401,733,1433,733,1312,0,121
1808816,18,11,1995,7,female,589,631,206,755,2405,755,2403,0,2
2148661,23,12,1990,12,female,81,627,514,781,3050,781,2743,0,307
1913969,18,14,1995,11,female,520,583,439,825,247,149,56,676,191
1451520,20,10,1993,11,female,168,586,311,850,466,481,411,369,55
1650923,23,27,1990,1,male,420,628,294,812,201,344,115,468,86
1699212,17,20,1996,4,female,1249,586,247,851,1263,475,557,376,706
1326672,19,29,1994,10,male,179,579,511,842,600,429,461,413,139
1487554,20,18,1993,7,female,862,627,519,841,834,387,321,454,513
1894529,21,30,1992,1,female,498,626,197,805,754,495,219,310,535
2116727,14,15,1999,11,female,78,624,414,844,148,834,113,10,35
2100020,18,2,1995,4,male,825,620,478,807,401,751,304,56,97
1544769,30,14,1983,3,male,936,605,488,830,262,670,220,160,42
1350593,17,30,1996,12,male,455,635,479,800,709,768,356,32,353
1968060,17,23,1996,4,male,720,591,331,853,1510,657,1285,196,225
1214044,17,30,1996,11,male,417,585,226,859,1417,857,1386,2,31
1095762,15,28,1998,4,female,476,630,344,903,662,142,152,761,510
1334218,17,30,1996,8,female,1096,615,276,977,847,29,402,948,445
1829135,20,26,1993,4,female,537,578,277,921,878,14,420,907,458
1046466,28,10,1985,12,female,213,606,186,957,867,17,148,940,719
1223421,16,20,1997,12,female,665,582,417,977,673,297,454,680,219
1839625,15,8,1998,4,female,244,633,228,986,993,641,732,345,261
1894783,17,25,1996,2,female,967,637,365,885,675,453,472,432,203
2025685,18,4,1995,9,male,599,628,444,923,591,550,406,373,185
1563021,24,27,1989,3,male,359,587,402,972,396,799,233,173,163
1231549,18,26,1995,3,female,236,588,268,892,764,852,538,40,226
1231668,22,17,1991,5,female,459,617,378,923,770,897,396,26,374
1378491,24,23,1989,7,female,837,579,431,944,764,873,372,71,392
1012535,38,1,1975,7,female,1731,635,419,933,991,768,662,165,329
1101041,29,13,1984,9,female,353,595,369,916,793,907,660,9,133
1589556,24,27,1989,7,female,1056,583,400,919,438,919,366,0,72
1928579,22,17,1991,12,female,302,584,45,908,709,908,661,0,48
1145097,18,23,1995,9,female,359,590,202,1018,450,596,307,422,143
1314476,19,28,1994,10,male,511,596,318,1102,590,365,198,737,392
1692916,22,11,1991,3,female,470,625,340,1028,270,609,124,419,146
1010975,29,7,1984,3,male,760,631,448,1099,2271,614,1216,485,1055
2110657,18,31,1995,8,male,280,575,415,1053,527,883,130,170,397
1594948,16,19,1997,9,female,383,577,188,1006,1287,994,1270,12,17
1949803,30,25,1983,10,male,457,627,469,1089,239,1081,215,8,24
1878769,23,16,1990,10,female,490,594,399,1122,1216,1121,842,1,374
2163680,25,19,1988,6,male,1320,607,423,1097,334,1097,300,0,34
1104115,26,16,1987,7,female,577,635,434,1103,1082,1103,852,0,230
1293520,18,12,1995,8,female,94,574,240,1185,792,0,88,1185,704
1966976,14,2,1999,9,male,246,599,367,1139,1857,107,1367,1032,490
1382633,17,20,1996,4,male,531,611,403,1178,1947,143,653,1035,1294
1146987,18,18,1995,5,male,262,638,509,1203,198,450,148,753,50
1511067,18,3,1995,6,female,317,622,234,1182,1427,810,487,372,940
1858429,22,18,1991,12,female,927,609,443,1136,852,648,397,488,455
1675283,15,26,1998,5,female,714,627,415,1216,875,971,679,245,196
1272847,19,8,1994,4,female,341,598,335,1146,1094,842,757,304,337
2008936,19,21,1994,6,female,1349,615,262,1265,842,1017,563,248,279
1055448,24,20,1989,10,female,1703,597,193,1204,1128,1116,1023,88,105
2172946,20,20,1993,11,female,522,611,90,1198,807,1188,357,10,450
1464595,21,10,1992,12,female,1046,576,338,1278,1706,1268,1311,10,395
2155461,23,5,1990,6,male,545,620,444,1269,324,1269,287,0,37
1138266,18,11,1995,12,female,315,610,349,1249,2322,1249,2092,0,230
1115549,29,8,1984,2,female,609,602,364,1445,603,171,62,1274,541
1090130,16,13,1997,12,male,207,584,282,1390,1609,875,1114,515,495
1845590,18,4,1995,7,male,557,579,300,1301,864,426,423,875,441
1352374,25,1,1988,4,female,1317,600,345,1344,1291,604,586,740,705
1967803,25,21,1988,9,male,577,624,459,1438,1344,797,776,641,568
1139184,33,17,1980,5,female,522,604,509,1467,226,1442,127,25,99
1318231,17,25,1996,11,female,1358,591,395,1335,288,1316,223,19,65
1428153,21,30,1992,7,female,94,637,420,1485,523,1458,455,27,68
1777104,21,21,1992,8,female,74,610,351,1353,1399,1317,1280,36,119
1535515,23,2,1990,1,female,510,629,440,1298,1522,1216,1172,81,350
1573494,25,1,1988,1,male,63,602,452,1299,1843,1242,1634,57,209
1831820,19,4,1994,4,male,483,584,320,1423,544,1423,508,0,36
2187837,29,26,1984,4,female,896,629,190,1321,621,1321,312,0,309
1186760,22,19,1991,11,female,1278,639,316,1674,2192,0,585,1674,1607
2072145,37,17,1976,1,female,560,574,388,1606,2107,260,1222,1346,885
1373348,15,23,1998,2,male,276,606,303,1626,1205,1103,1018,523,187
1170563,18,18,1995,5,female,238,580,168,1663,1890,389,1102,1274,788
2088760,20,4,1993,10,female,409,592,475,1761,1373,704,762,1057,611
1488991,15,7,1998,2,male,667,611,460,1652,840,1619,576,33,264
2100097,15,28,1998,8,female,591,629,453,1793,473,1479,152,314,321
1243990,18,10,1995,11,female,449,576,304,1816,1955,1722,1815,94,140
1198028,28,18,1985,3,female,355,611,378,1597,1329,1544,548,53,781
1870111,29,28,1984,7,female,424,615,282,1563,608,1563,564,0,44
1939868,30,15,1983,10,female,1021,626,469,1981,1108,1383,375,598,733
1923210,14,14,1999,11,female,329,579,342,2345,3455,1601,2179,744,1276
1164352,18,29,1995,9,male,482,576,400,1929,294,1867,237,62,57
1512796,13,13,2000,2,female,845,582,369,2178,990,2145,796,33,194
1212093,14,5,1999,2,female,350,586,320,2190,442,2033,289,157,153
1339706,17,25,1996,3,female,335,598,248,1918,1061,1819,296,99,765
1107201,19,30,1994,10,male,229,595,387,2302,940,2292,648,10,292
1242435,18,5,1995,6,female,660,599,371,1953,1207,1952,1046,1,161
1841091,25,12,1988,7,male,387,631,441,2140,328,2140,311,0,17
1541871,28,4,1985,8,male,283,598,372,2179,235,2179,172,0,63
2137609,19,28,1994,12,male,194,583,410,2065,540,2065,501,0,39
1492394,18,22,1995,1,female,456,602,461,2133,1056,2133,990,0,66
1708755,26,1,1987,10,male,534,603,491,2248,1128,2248,583,0,545
1275431,14,12,1999,11,female,355,628,448,2662,859,1840,459,822,400
1101734,14,16,1999,12,female,327,628,72,3240,1480,1311,342,1929,1138
1314990,23,15,1990,11,female,793,591,365,2775,1610,1721,899,1054,711
1784942,15,19,1998,11,male,617,608,384,2593,2240,1498,1928,1095,312
1653134,33,15,1980,7,female,1832,620,133,2656,2816,545,1224,2111,1592
1450609,19,21,1994,9,female,1545,630,177,2664,4253,1724,2665,940,1588
1444084,17,16,1996,8,male,205,628,581,2472,192,2366,133,106,59
2071670,28,30,1985,3,female,179,609,585,2850,435,2733,294,117,141
1241151,15,1,1998,9,female,888,628,386,2844,1115,2221,606,623,509
1872512,17,13,1996,8,female,328,597,370,2797,1007,2527,760,270,247
2153716,21,12,1992,12,female,530,609,292,3504,1749,3159,775,345,974
1632098,21,30,1992,1,female,732,574,426,3257,1261,3139,1037,118,224
2153221,17,31,1996,12,male,161,637,362,2402,2922,2399,1416,3,1506
1156054,16,27,1997,5,male,253,585,509,2945,460,2945,395,0,65
1854942,21,24,1992,4,male,248,606,326,2767,880,2767,675,0,205
1012110,27,22,1986,11,male,218,618,224,3224,1409,3224,1011,0,398
1659382,13,3,2000,8,male,332,618,246,3764,2125,2660,1724,1104,401
1615848,18,1,1995,11,female,45,591,490,7419,4354,2208,2419,5211,1935
1206709,17,16,1996,8,female,449,589,475,4348,3446,2021,1983,2327,1463
1476798,20,14,1993,4,male,510,575,38,8032,2653,6144,1108,1888,1545
1764574,26,30,1987,6,male,111,601,283,8942,6575,8776,4216,166,2359
1914640,14,25,1999,4,male,173,597,387,8200,1386,8140,862,60,524
1289193,23,15,1990,3,male,457,598,497,4576,1536,4576,1251,0,285
1609509,24,26,1989,3,female,421,617,291,9552,1704,9552,1536,0,168
1412849,31,1,1982,10,female,133,582,133,14039,3274,14039,3077,0,197
1620463,23,20,1990,3,female,284,648,202,102,719,13,292,89,427
2011997,23,9,1990,9,male,289,654,618,101,29,70,23,31,6
1771206,14,15,1999,11,male,211,686,420,103,464,38,72,65,392
2086749,35,12,1978,4,female,551,706,533,104,233,73,179,31,54
1051861,29,16,1984,8,female,831,680,444,101,109,101,42,0,67
2153431,31,12,1982,6,female,597,671,171,102,379,102,337,0,42
1708726,17,28,1996,11,male,578,671,408,106,527,52,286,54,241
1048132,23,10,1990,11,male,801,642,501,107,50,105,44,2,6
1761801,19,23,1994,7,female,481,684,460,106,101,95,41,11,60
1643925,14,10,1999,5,female,321,659,325,106,167,80,85,26,82
1897479,19,23,1994,12,female,578,688,237,105,257,102,182,3,75
1619669,32,9,1981,6,male,571,680,408,108,208,96,102,12,106
1797193,21,21,1992,11,male,438,646,278,109,215,109,73,0,142
1656621,20,12,1993,4,male,170,641,544,105,229,105,187,0,42
1501136,23,30,1990,7,male,1380,641,458,113,118,74,91,39,27
2092807,25,13,1988,9,female,913,696,136,111,401,82,350,29,51
1422810,35,16,1978,4,female,1864,666,487,110,306,108,79,2,227
1342921,23,10,1990,8,male,1056,715,436,113,97,113,78,0,19
2029733,14,18,1999,8,male,176,690,640,115,32,18,10,97,22
1840742,16,14,1997,1,male,609,701,444,119,67,42,25,77,42
1929816,15,8,1998,4,female,211,671,528,118,104,75,77,43,27
1280480,18,13,1995,4,male,564,683,459,114,215,64,80,50,135
1342809,19,13,1994,6,male,239,670,468,115,538,55,195,60,343
1602844,24,4,1989,1,male,894,649,605,118,16,118,15,0,1
1996305,17,26,1996,1,male,215,680,608,116,604,116,275,0,329
1181047,18,10,1995,8,female,309,671,263,114,476,114,448,0,28
1264782,19,12,1994,10,male,667,682,395,121,256,121,173,0,83
2176665,27,12,1986,2,male,721,676,354,126,415,12,168,114,247
2172777,19,4,1994,4,male,530,660,557,126,165,126,151,0,14
1104426,23,13,1990,1,male,435,662,555,130,97,130,87,0,10
1212524,24,14,1989,4,female,1465,644,340,127,130,127,67,0,63
1213415,20,3,1993,2,female,639,688,323,130,474,130,275,0,199
1866371,37,6,1976,11,female,473,702,608,126,1246,126,768,0,478
1839028,18,6,1995,7,female,52,668,68,132,442,74,377,58,65
1925495,23,30,1990,6,male,1890,696,430,132,85,118,61,14,24
1274776,15,15,1998,8,female,19,641,128,134,44,134,42,0,2
1034947,17,15,1996,7,female,454,656,461,132,185,132,91,0,94
1847553,15,1,1998,1,male,22,670,611,137,98,9,47,128,51
2098578,20,16,1993,3,female,621,692,441,143,173,27,77,116,96
1416740,15,21,1998,4,female,448,653,402,141,295,8,47,133,248
1331695,17,26,1996,1,female,1160,712,554,140,120,73,86,67,34
1054083,20,2,1993,2,female,633,674,324,138,260,61,92,77,168
1687710,19,19,1994,3,female,1571,713,164,140,458,119,164,21,294
1871114,40,26,1973,2,female,1617,660,371,139,609,110,533,29,76
1986438,19,25,1994,7,female,574,714,462,140,242,140,188,0,54
1354818,25,12,1988,9,male,577,677,486,146,158,136,107,10,51
1981113,39,27,1974,3,female,611,657,477,148,423,126,139,22,284
1085842,16,19,1997,9,male,428,710,535,150,3,150,3,0,0
1586142,21,3,1992,6,male,747,649,491,144,20,144,14,0,6
1567006,26,10,1987,1,male,462,681,223,149,84,149,79,0,5
1934663,19,24,1994,8,female,813,713,350,152,95,102,55,50,40
1922364,27,18,1986,1,female,986,640,366,155,213,71,78,84,135
2044180,22,21,1991,7,male,254,707,545,157,345,100,264,57,81
1341205,18,21,1995,1,male,629,644,527,155,63,133,44,22,19
1864775,16,16,1997,11,female,653,695,518,152,151,125,144,27,7
2001158,23,9,1990,6,female,721,692,353,151,173,145,63,6,110
1632074,13,4,2000,2,male,285,688,428,153,56,153,50,0,6
1697163,19,18,1994,3,male,141,656,597,159,57,0,33,159,24
2128357,18,17,1995,1,female,1397,673,287,162,370,145,121,17,249
1827504,17,17,1996,4,female,607,705,385,158,189,158,121,0,68
1053851,20,10,1993,10,female,610,694,243,163,317,163,247,0,70
1971699,22,3,1991,3,female,39,656,298,166,377,79,167,87,210
1360449,35,10,1978,11,female,548,673,157,166,527,98,191,68,336
1300669,20,19,1993,10,female,244,686,202,171,848,155,589,16,259
1258431,22,13,1991,4,male,933,651,162,170,205,170,151,0,54
1138765,15,29,1998,4,female,831,683,157,180,133,40,23,140,110
1510553,16,5,1997,7,female,135,672,568,178,22,169,20,9,2
1467401,21,5,1992,3,male,545,646,550,176,117,175,100,1,17
2147727,23,2,1990,8,male,244,661,617,176,82,176,67,0,15
1696449,23,25,1990,10,male,1091,687,531,176,88,176,71,0,17
1095765,15,10,1998,2,female,103,696,298,174,276,174,188,0,88
1985427,16,2,1997,7,male,500,662,565,185,110,96,31,89,79
1431770,15,27,1998,1,male,730,684,544,187,214,78,126,109,88
1063197,19,9,1994,7,male,507,652,403,186,133,143,74,43,59
1363860,23,20,1990,6,female,206,700,321,187,383,137,259,50,124
2018233,24,9,1989,2,male,601,708,536,186,584,186,500,0,84
1708229,34,9,1979,7,female,1043,645,202,186,534,186,513,0,21
1345843,25,10,1988,4,male,594,641,513,191,93,87,48,104,45
1827677,23,3,1990,7,female,1421,643,243,200,156,169,64,31,92
1512991,18,2,1995,2,male,96,670,541,199,354,188,309,11,45
1326696,22,20,1991,4,male,719,652,610,196,43,196,29,0,14
1612855,15,26,1998,6,female,380,674,199,194,199,194,52,0,147
1831177,25,6,1988,4,male,372,694,282,191,292,191,230,0,62
1633101,18,15,1995,6,male,614,644,478,210,195,132,110,78,85
2110374,17,13,1996,6,female,560,665,391,202,299,200,183,2,116
1718322,18,6,1995,8,female,792,659,259,210,29,210,17,0,12
1897092,27,3,1986,4,female,536,669,441,203,83,203,37,0,46
1193381,22,28,1991,10,male,291,665,535,205,138,205,122,0,16
1784264,14,16,1999,8,female,100,655,301,203,603,203,445,0,158
1255794,18,11,1995,10,female,439,641,171,217,103,100,46,117,57
1030696,22,22,1991,5,female,524,719,524,219,816,49,439,170,377
2123753,29,20,1984,10,male,38,684,544,212,1008,139,777,73,231
1236147,18,20,1995,2,female,1469,684,340,214,348,210,278,4,70
2034253,19,16,1994,10,female,195,688,165,221,403,175,250,46,153
1641981,17,21,1996,2,female,612,653,264,220,647,220,424,0,223
1888740,14,31,1999,8,female,268,662,315,222,47,48,20,174,27
1734935,22,20,1991,2,female,557,663,515,229,326,102,124,127,202
1485687,16,14,1997,5,male,758,714,249,222,938,52,463,170,475
1261772,17,5,1996,5,male,1006,654,403,229,1224,160,786,69,438
1290457,18,16,1995,1,female,532,661,340,231,111,226,78,5,33
1154280,24,17,1989,3,female,596,656,502,224,197,187,86,37,111
1237095,15,15,1998,1,female,743,687,518,222,61,221,50,1,11
2075076,23,2,1990,6,male,549,656,473,227,132,227,116,0,16
2063953,19,12,1994,9,female,344,690,208,238,176,17,110,221,66
1089973,24,17,1989,3,male,386,654,585,241,227,0,44,241,183
1351300,15,7,1998,8,male,237,701,579,243,219,132,131,111,88
1375870,16,2,1997,3,female,427,682,210,238,561,65,245,173,316
1076560,23,3,1990,6,male,1992,699,379,236,392,171,262,65,130
2021341,16,17,1997,5,female,407,654,528,241,285,241,243,0,42
1744811,21,18,1992,12,male,184,696,650,247,63,0,13,247,50
1250794,19,26,1994,6,male,641,664,350,247,443,82,135,165,308
2109182,19,4,1994,8,female,162,711,449,249,387,171,129,78,258
1069426,24,15,1989,2,male,679,716,285,252,62,252,50,0,12
1504013,24,30,1989,7,female,541,655,371,257,137,257,68,0,69
1102651,18,5,1995,8,male,333,644,539,249,249,249,158,0,91
1076736,16,19,1997,9,female,236,714,445,274,7,184,5,90,2
1448088,15,5,1998,2,male,512,689,630,264,103,217,84,47,19
2150961,23,10,1990,10,female,235,648,93,272,85,259,50,13,35
1023145,19,30,1994,4,male,486,697,523,263,139,263,99,0,40
2013164,29,13,1984,4,female,661,710,301,266,368,266,347,0,21
1443330,27,2,1986,8,female,1199,714,475,264,1009,264,903,0,106
2046278,22,6,1991,3,male,388,706,526,277,190,7,139,270,51
1139498,14,18,1999,2,female,224,692,542,290,289,193,204,97,85
1285437,20,25,1993,2,male,627,676,459,277,83,271,74,6,9
1621226,19,4,1994,7,female,349,648,139,278,268,273,267,5,1
1978608,16,7,1997,1,male,745,715,405,278,90,278,50,0,40
2101088,30,13,1983,7,male,628,690,429,288,144,288,137,0,7
2053306,21,17,1992,9,male,518,649,317,287,250,287,212,0,38
1295718,19,17,1994,6,female,242,694,213,278,469,278,371,0,98
1375724,15,21,1998,2,male,557,640,387,304,34,3,5,301,29
1998757,18,7,1995,4,female,333,692,339,294,400,197,237,97,163
1820724,20,28,1993,11,male,752,696,191,305,398,163,146,142,252
1265126,24,27,1989,7,male,1068,671,293,294,328,154,149,140,179
1880610,18,28,1995,4,male,573,720,464,298,207,276,180,22,27
1435422,16,6,1997,3,female,197,663,353,302,878,288,378,14,500
1749501,24,13,1989,12,male,892,704,556,302,555,238,512,64,43
1776062,18,4,1995,5,male,221,661,629,306,124,306,77,0,47
1584208,27,4,1986,8,male,274,651,548,306,296,306,208,0,88
1075098,16,24,1997,8,female,790,680,429,324,395,11,148,313,247
1503665,19,27,1994,10,female,414,673,479,321,196,58,53,263,143
1330225,25,16,1988,11,male,842,675,492,314,249,153,112,161,137
1321450,36,4,1977,7,female,390,661,425,309,559,129,410,180,149
1833955,18,7,1995,1,female,1547,663,313,321,228,288,91,33,137
1492569,18,9,1995,8,female,263,671,168,325,602,270,301,55,301
1475527,31,10,1982,6,female,235,693,12,327,1407,284,432,43,975
1315235,16,14,1997,9,male,492,662,546,309,22,309,15,0,7
1118596,14,24,1999,5,female,425,710,200,316,86,316,64,0,22
2048149,18,19,1995,11,male,648,680,506,338,11,0,4,338,7
1378853,17,15,1996,3,male,639,695,508,344,378,38,222,306,156
1371381,18,3,1995,3,female,433,701,230,332,475,296,419,36,56
1280992,25,2,1988,11,female,539,678,477,334,253,248,122,86,131
1217083,19,28,1994,7,female,531,640,80,335,869,328,620,7,249
1547457,16,5,1997,6,male,65,660,631,346,24,346,21,0,3
1115293,17,22,1996,4,male,230,699,587,344,127,344,78,0,49
2191391,19,25,1994,3,male,475,716,486,331,312,331,279,0,33
1901929,20,19,1993,10,female,470,650,309,347,187,56,147,291,40
1477937,15,23,1998,10,female,192,640,472,355,487,62,293,293,194
1968677,15,6,1998,7,female,164,692,417,352,462,128,254,224,208
2030973,17,21,1996,12,female,673,697,459,347,479,283,110,64,369
1167082,18,20,1995,3,male,596,657,288,347,315,255,182,92,133
1993267,19,18,1994,10,female,463,695,366,366,362,284,175,82,187
1076507,16,16,1997,5,female,472,658,403,352,602,333,463,19,139
1934714,16,21,1997,2,female,597,667,527,365,374,362,99,3,275
1950783,23,18,1990,4,male,641,718,448,360,155,360,139,0,16
1669121,18,8,1995,3,male,583,675,493,368,423,368,390,0,33
1742777,16,10,1997,4,male,658,645,244,379,95,0,36,379,59
1993159,15,12,1998,3,female,476,678,425,385,344,49,109,336,235
1984301,18,16,1995,10,female,536,647,379,378,143,267,80,111,63
2046187,18,3,1995,4,female,637,716,351,394,493,266,145,128,348
1328197,14,7,1999,5,female,54,671,247,383,724,104,420,279,304
1911770,15,10,1998,2,male,509,652,256,388,863,193,646,195,217
1291853,19,3,1994,5,female,450,697,253,373,625,98,392,275,233
1805277,23,4,1990,11,male,1706,660,276,370,919,266,564,104,355
1574114,16,22,1997,4,male,433,692,289,378,145,302,73,76,72
1512327,19,15,1994,8,male,611,648,511,381,237,309,219,72,18
1298134,16,17,1997,9,female,442,708,425,370,677,364,513,6,164
2168484,19,6,1994,11,female,602,686,258,377,1407,331,624,46,783
1103869,16,21,1997,9,male,611,654,617,370,17,370,14,0,3
1474177,18,25,1995,12,male,940,713,518,388,551,388,511,0,40
1628242,19,20,1994,12,male,871,640,329,406,229,242,119,164,110
1608015,24,1,1989,12,female,1073,676,497,412,407,166,265,246,142
2051697,30,20,1983,4,male,1115,640,342,410,728,278,293,132,435
1032261,18,8,1995,1,female,308,661,327,417,655,410,506,7,149
1698158,22,26,1991,5,female,414,700,165,411,617,395,526,16,91
1380701,40,17,1973,2,female,812,706,316,397,1100,389,507,8,593
1514498,22,12,1991,5,male,697,707,624,418,89,418,59,0,30
2087812,22,16,1991,5,male,158,646,591,421,468,421,394,0,74
2121194,29,29,1984,2,female,776,660,409,405,365,405,179,0,186
1106707,16,13,1997,12,female,1019,715,530,425,152,0,73,425,79
1773073,14,11,1999,3,female,505,697,208,445,777,82,554,363,223
1291487,17,17,1996,10,female,260,663,385,438,326,232,78,206,248
1141603,30,12,1983,11,female,208,698,191,438,400,168,84,270,316
1247887,16,30,1997,4,female,404,681,383,439,1471,308,943,131,528
1846052,16,29,1997,11,female,300,694,305,438,569,374,284,64,285
2134339,16,1,1997,7,male,482,661,507,429,431,357,235,72,196
1225014,18,7,1995,3,female,900,720,197,427,301,324,93,103,208
2111555,19,7,1994,9,male,428,663,499,427,1208,417,839,10,369
1078334,32,25,1981,5,male,605,671,554,449,35,448,24,1,11
2184248,15,12,1998,9,female,625,650,450,432,225,432,81,0,144
1516259,16,9,1997,7,female,560,684,402,422,174,422,127,0,47
1974869,27,24,1986,5,female,674,717,512,444,267,444,90,0,177
1462221,16,3,1997,3,female,169,655,261,432,458,432,182,0,276
2142758,34,1,1979,2,male,654,703,494,438,354,438,191,0,163
2046382,19,15,1994,5,female,664,688,355,446,1562,446,1510,0,52
1974879,17,5,1996,3,female,449,671,177,476,504,49,118,427,386
1908004,23,4,1990,10,male,270,640,391,455,275,291,69,164,206
1568087,15,6,1998,10,male,404,678,514,479,502,119,278,360,224
1728805,16,18,1997,1,female,733,712,340,466,383,215,186,251,197
1171529,28,23,1985,12,female,179,705,606,454,427,272,258,182,169
1827703,27,23,1986,4,female,403,669,596,475,701,234,556,241,145
1521558,31,28,1982,2,female,1720,645,368,481,853,177,683,304,170
1167512,17,15,1996,6,male,722,682,394,474,149,456,98,18,51
1477547,29,13,1984,9,female,1346,681,621,465,511,374,378,91,133
2027196,16,18,1997,10,male,249,698,611,463,40,463,37,0,3
1103340,21,11,1992,7,female,315,648,58,475,179,475,129,0,50
1839146,24,22,1989,5,male,647,709,395,482,572,482,527,0,45
1997954,28,13,1985,3,female,286,669,403,482,1195,482,1074,0,121
2177713,18,26,1995,7,female,543,649,281,509,1452,90,986,419,466
1920598,14,9,1999,7,male,286,656,513,497,25,196,16,301,9
1053684,26,23,1987,10,male,217,697,425,512,210,144,77,368,133
1463119,14,20,1999,4,female,710,704,405,514,512,370,236,144,276
1719302,21,19,1992,2,male,622,685,551,492,783,309,464,183,319
1521754,18,20,1995,7,female,609,701,509,492,534,438,288,54,246
1050127,22,10,1991,8,female,530,651,288,490,311,457,262,33,49
1189018,36,12,1977,12,female,1242,694,276,497,584,413,239,84,345
1277120,19,20,1994,1,male,477,689,324,489,1092,486,1030,3,62
1954263,16,6,1997,1,male,206,644,368,540,1269,45,1014,495,255
1739616,25,27,1988,5,male,18,689,624,549,1677,78,392,471,1285
1408739,25,6,1988,3,female,1453,642,231,543,766,253,253,290,513
1919832,18,2,1995,8,male,410,690,567,541,284,523,131,18,153
1951128,24,3,1989,9,female,638,641,404,557,129,483,106,74,23
1249708,19,12,1994,11,female,533,688,366,556,678,501,548,55,130
1962226,25,26,1988,2,male,93,674,565,534,1252,534,1138,0,114
1243542,14,9,1999,4,female,271,713,300,567,981,51,287,516,694
1700616,20,11,1993,5,male,1106,706,480,607,129,376,79,231,50
2123544,18,1,1995,1,male,860,689,440,585,385,237,201,348,184
2072165,21,4,1992,10,male,405,668,421,593,1642,267,1070,326,572
1716822,16,26,1997,12,female,915,657,413,592,131,478,39,114,92
1318327,18,9,1995,8,female,486,661,527,581,286,524,256,57,30
1755134,15,19,1998,11,female,827,675,440,591,536,450,191,141,345
2162451,16,16,1997,4,male,285,705,289,590,397,556,88,34,309
1094415,24,24,1989,8,male,602,644,551,564,627,563,498,1,129
1844361,30,15,1983,4,female,1643,713,355,609,587,606,450,3,137
1388358,25,21,1988,9,female,552,711,581,572,319,572,199,0,120
1876243,31,7,1982,3,male,725,652,446,583,859,583,801,0,58
1739930,35,5,1978,1,female,860,704,64,582,461,582,445,0,16
1301922,27,28,1986,7,female,1860,703,473,642,771,250,414,392,357
2096743,24,13,1989,1,male,196,683,659,614,195,484,134,130,61
1027111,21,16,1992,8,male,231,640,532,642,614,607,385,35,229
1576875,27,14,1986,9,female,586,692,534,613,762,603,602,10,160
1017036,38,1,1975,12,male,356,683,499,640,455,469,298,171,157
1337842,20,27,1993,5,male,407,694,632,692,368,0,116,692,252
2062291,20,6,1993,5,female,258,703,490,710,629,13,401,697,228
2093774,19,2,1994,5,female,885,692,238,719,115,507,58,212,57
1712424,18,19,1995,7,female,467,647,499,683,129,294,92,389,37
1320354,22,22,1991,7,male,419,710,656,685,133,403,74,282,59
1844903,16,7,1997,7,male,627,659,448,723,638,417,297,306,341
1788221,17,9,1996,8,male,583,698,410,674,537,337,262,337,275
1900872,23,27,1990,12,female,482,720,439,670,517,220,162,450,355
1814458,24,5,1989,1,female,584,659,521,666,535,287,240,379,295
1894211,25,21,1988,2,female,695,710,587,718,598,416,409,302,189
1847803,20,2,1993,6,female,211,662,212,714,3133,394,1011,320,2122
1458527,20,6,1993,5,female,508,675,534,665,123,653,114,12,9
1500797,19,8,1994,12,female,225,691,500,705,974,605,809,100,165
1178752,25,23,1988,11,male,540,708,623,676,956,615,311,61,645
1173230,30,27,1983,9,female,775,649,362,687,557,676,422,11,135
1662111,19,12,1994,9,female,193,650,352,715,1678,642,1008,73,670
1000382,16,23,1997,1,male,465,703,310,665,888,665,672,0,216
2179339,17,10,1996,4,female,262,703,213,714,528,714,328,0,200
1916970,19,18,1994,5,male,409,717,510,714,729,714,573,0,156
1585746,19,17,1994,8,male,598,665,358,745,351,506,248,239,103
1926997,23,30,1990,9,female,700,678,425,765,1040,216,679,549,361
2037147,18,5,1995,9,female,800,716,455,796,1328,193,576,603,752
2005494,18,21,1995,1,female,411,703,276,770,564,583,220,187,344
1212208,19,23,1994,1,female,379,667,453,755,667,707,609,48,58
1658702,19,7,1994,8,male,299,664,292,793,686,776,471,17,215
1579356,15,28,1998,1,female,222,643,233,791,2500,717,1424,74,1076
2046806,15,22,1998,6,female,468,720,350,758,797,752,526,6,271
1411272,24,5,1989,6,female,365,652,225,758,736,752,293,6,443
1839404,15,25,1998,8,female,345,702,91,740,365,740,239,0,126
1373319,16,21,1997,12,male,251,642,248,794,669,794,500,0,169
1467431,18,25,1995,11,female,99,691,292,742,490,742,469,0,21
1823289,25,24,1988,1,female,494,716,165,778,534,778,401,0,133
1972927,15,24,1998,7,female,503,670,429,871,218,0,112,871,106
1382241,38,8,1975,9,female,1327,656,473,816,436,239,253,577,183
2080720,14,27,1999,7,female,172,681,404,870,754,478,464,392,290
1872507,15,26,1998,1,female,92,694,269,857,1170,287,181,570,989
1133539,21,23,1992,4,female,407,712,358,811,787,245,173,566,614
1124373,23,26,1990,2,female,1091,648,240,878,1591,303,912,575,679
1272813,16,27,1997,12,male,385,674,407,835,800,624,556,211,244
1359096,23,9,1990,12,female,280,675,622,857,589,743,374,114,215
1985586,19,6,1994,1,female,107,676,541,821,1854,696,1304,125,550
1834641,15,10,1998,1,female,531,700,407,806,771,804,476,2,295
1146791,16,2,1997,2,female,82,685,563,870,155,870,117,0,38
1455527,16,28,1997,3,female,358,653,351,841,407,841,360,0,47
1592881,32,23,1981,6,male,412,671,611,823,310,823,232,0,78
1716877,20,25,1993,4,female,327,708,201,844,1629,844,1575,0,54
1044825,23,27,1990,2,male,76,704,676,871,1628,871,1326,0,302
2009918,19,13,1994,5,male,337,659,586,954,418,121,266,833,152
2166003,19,19,1994,8,female,987,670,271,937,1123,528,697,409,426
2114608,20,16,1993,6,female,684,676,381,891,794,613,470,278,324
1849425,26,12,1987,8,female,1733,657,301,891,1529,368,888,523,641
1027350,18,1,1995,2,male,796,644,236,884,451,864,344,20,107
1190719,23,17,1990,10,male,222,692,424,884,533,653,217,231,316
1753790,14,30,1999,11,female,502,654,301,962,1025,712,415,250,610
2045855,13,19,2000,1,female,278,651,471,937,1131,857,625,80,506
2156427,18,3,1995,12,female,190,640,160,880,1977,657,1087,223,890
1877776,15,10,1998,6,female,516,642,258,922,1015,914,553,8,462
1820850,16,14,1997,8,female,307,652,277,897,713,895,159,2,554
1536933,33,19,1980,5,female,1777,660,306,967,632,958,417,9,215
1958062,20,7,1993,4,male,178,707,536,931,225,931,188,0,37
1222273,16,4,1997,12,female,598,670,224,1063,513,144,197,919,316
1054483,30,10,1983,9,female,718,710,260,1084,324,0,150,1084,174
1007921,17,18,1996,10,female,467,683,270,1051,930,96,293,955,637
1876725,19,26,1994,3,female,484,695,391,1125,1311,97,469,1028,842
1482396,19,19,1994,3,female,330,672,350,1037,1339,168,301,869,1038
1357913,29,28,1984,5,female,517,654,457,1053,909,137,182,916,727
1893571,15,15,1998,6,female,179,644,405,1033,611,457,249,576,362
1602478,26,10,1987,11,female,1082,686,470,1019,222,683,54,336,168
2094668,16,22,1997,1,female,866,647,449,1000,640,495,374,505,266
1438917,23,6,1990,12,female,1604,654,232,1089,1037,579,589,510,448
1162607,21,16,1992,2,female,375,643,391,1122,2046,493,967,629,1079
1941947,19,21,1994,3,male,720,665,491,1036,451,762,409,274,42
1910004,18,11,1995,11,male,888,701,346,1050,903,994,384,56,519
1852567,18,23,1995,2,female,59,714,593,1016,922,957,442,59,480
2103341,31,18,1982,9,male,838,719,342,1036,1043,972,922,64,121
1156122,18,18,1995,8,female,137,665,315,1054,2494,794,713,260,1781
2148259,40,21,1973,2,female,1926,670,317,1046,1572,907,1295,139,277
1959966,14,22,1999,2,male,210,694,369,1111,89,1109,74,2,15
2096383,18,12,1995,12,female,575,646,444,1014,660,1014,489,0,171
1259573,19,9,1994,7,female,1181,672,348,1045,1445,1045,1254,0,191
1085532,31,6,1982,2,female,608,711,68,1030,643,1030,399,0,244
1821608,18,5,1995,5,male,88,649,640,1162,1155,214,153,948,1002
1943540,23,26,1990,5,female,482,706,442,1273,1903,106,346,1167,1557
1686794,27,23,1986,9,male,1498,648,497,1187,1578,0,412,1187,1166
1596407,16,28,1997,8,female,351,658,512,1185,509,279,218,906,291
1612868,20,5,1993,3,female,466,651,586,1161,773,254,594,907,179
1083338,17,26,1996,4,female,31,652,45,1138,2913,426,858,712,2055
1030228,20,27,1993,10,female,81,701,409,1189,2069,378,1257,811,812
2168439,16,16,1997,1,female,790,685,266,1162,263,1096,206,66,57
1720535,17,27,1996,1,female,369,718,509,1195,441,1000,191,195,250
1375789,19,10,1994,8,female,1246,660,428,1139,257,968,121,171,136
2029723,15,28,1998,2,female,164,718,424,1149,2024,1064,1052,85,972
1560123,29,28,1984,8,female,1849,716,269,1175,2336,849,1717,326,619
1743019,15,2,1998,6,male,529,643,390,1263,544,1262,335,1,209
1027240,20,1,1993,9,female,165,655,521,1133,3018,1133,2787,0,231
2067061,34,18,1979,5,female,1340,659,368,1524,793,625,502,899,291
1962794,20,7,1993,6,female,677,671,420,1296,1641,455,447,841,1194
1058107,20,20,1993,9,female,324,721,357,1422,2080,790,627,632,1453
1018074,22,19,1991,11,female,261,665,297,1423,1794,453,747,970,1047
1913205,23,12,1990,4,female,624,700,332,1480,2149,890,612,590,1537
1226989,34,2,1979,4,female,73,695,594,1338,948,354,700,984,248
1874651,15,25,1998,3,female,458,669,559,1474,204,1454,123,20,81
1590032,17,19,1996,1,female,218,702,595,1291,507,1051,312,240,195
1987932,20,18,1993,9,female,604,647,438,1289,781,1161,179,128,602
1802319,19,7,1994,6,male,515,657,472,1436,914,1290,574,146,340
2114364,16,13,1997,1,female,536,721,414,1434,984,1432,939,2,45
2080835,15,24,1998,3,male,435,676,403,1291,265,1291,225,0,40
1987060,18,26,1995,6,female,389,690,378,1394,1019,1394,992,0,27
2123959,32,11,1981,11,female,749,696,453,1578,893,0,333,1578,560
1654590,22,1,1991,1,female,395,681,523,1816,835,1214,497,602,338
1707406,15,8,1998,2,female,339,681,288,1719,1145,513,437,1206,708
1068924,24,13,1989,7,female,118,644,526,1599,1635,524,748,1075,887
1619856,14,16,1999,4,female,494,651,400,1652,361,1566,244,86,117
2070802,15,6,1998,7,male,177,662,395,1814,390,1660,183,154,207
1810953,17,6,1996,11,female,128,695,395,1723,2062,1638,1869,85,193
1227189,23,11,1990,4,female,1369,685,285,1728,2170,1363,1579,365,591
1416700,32,24,1981,10,female,592,692,400,1630,1003,1189,574,441,429
1937572,16,26,1997,3,female,125,657,546,1561,710,1561,454,0,256
1216586,31,15,1982,7,female,298,658,554,1550,425,1550,387,0,38
1391040,18,26,1995,3,female,151,652,280,1552,1017,1552,805,0,212
1803607,23,12,1990,9,female,375,645,127,1669,2772,1669,2419,0,353
1276261,18,12,1995,4,male,873,701,376,2218,991,1361,808,857,183
1082716,18,3,1995,11,female,592,715,260,2022,2495,1443,1411,579,1084
1344510,18,12,1995,11,female,14,652,312,2083,2104,693,1241,1390,863
1149531,41,18,1972,8,female,983,716,349,2089,2700,982,1491,1107,1209
1700565,18,19,1995,12,male,816,716,523,2236,3858,691,1685,1545,2173
1411114,40,8,1973,7,female,1718,645,356,2342,3530,1537,2852,805,678
2061684,14,14,1999,2,female,420,700,370,1937,626,1793,425,144,201
1427539,15,18,1998,6,female,779,720,441,2093,382,2002,224,91,158
1014918,17,27,1996,8,female,800,682,568,2130,1237,1855,522,275,715
1747864,18,31,1995,8,male,261,656,521,2054,477,1965,446,89,31
1817569,14,10,1999,12,female,277,673,178,2190,2334,1588,1062,602,1272
2066065,16,28,1997,9,female,614,672,342,2105,2892,1552,2056,553,836
1051038,22,28,1991,10,female,403,667,261,2344,2646,2255,1657,89,989
1144932,24,1,1989,3,male,151,719,496,2101,1787,1753,1035,348,752
1068552,25,5,1988,2,female,112,662,497,2194,1035,2192,879,2,156
1185177,20,24,1993,7,female,377,718,522,2081,2241,2080,2148,1,93
1404679,26,24,1987,6,male,1109,698,518,1919,996,1919,929,0,67
1622994,17,5,1996,3,female,565,715,488,2917,1497,160,562,2757,935
1717159,21,1,1992,8,male,550,661,457,3160,1404,935,617,2225,787
2113356,20,2,1993,7,female,504,682,552,3038,169,2921,61,117,108
1310318,17,5,1996,7,female,713,702,352,2721,593,2682,229,39,364
2080950,18,12,1995,2,female,237,693,343,2872,535,2754,339,118,196
1730880,23,13,1990,3,male,313,668,625,2691,647,2120,401,571,246
1565140,21,6,1992,8,female,1659,643,384,2870,2408,2220,2031,650,377
1850075,15,24,1998,11,female,291,650,193,3098,164,3081,144,17,20
1990397,21,16,1992,2,male,446,691,521,3067,348,3058,271,9,77
1370944,18,3,1995,9,female,437,652,356,3518,1631,3517,1051,1,580
1060338,22,18,1991,11,female,633,717,285,2594,761,2579,409,15,352
1147777,22,4,1991,10,male,1295,708,286,5358,8712,31,3872,5327,4840
1829040,21,18,1992,2,female,331,686,510,5421,3135,3885,2196,1536,939
1916859,25,17,1988,1,female,62,685,498,4293,2816,1537,548,2756,2268
2000165,30,27,1983,1,female,700,642,373,4188,3671,2084,2384,2104,1287
2043030,26,2,1987,10,male,278,650,310,8802,1332,8571,921,231,411
1173522,16,18,1997,12,female,735,695,525,8104,3276,7090,2200,1014,1076
1232906,15,30,1998,8,male,177,691,51,9804,3763,9321,1758,483,2005
2175941,18,25,1995,2,male,2,640,299,5640,2542,4251,1587,1389,955
1220122,30,5,1983,1,female,871,680,233,7654,2478,6654,1365,1000,1113
1917123,17,20,1996,4,male,633,697,413,3901,2721,3622,2082,279,639
1548566,41,17,1972,5,female,1583,642,521,3818,2570,3800,1538,18,1032
1799582,17,28,1996,8,female,586,660,56,10849,5122,10849,4692,0,430
1602106,18,14,1995,3,female,709,652,303,11510,1939,11510,1795,0,144
1790812,35,4,1978,12,female,183,682,76,5880,1375,5880,1340,0,35
1329599,36,16,1977,9,male,315,710,205,3741,1885,3741,1528,0,357
1470629,25,8,1988,8,male,856,728,607,104,128,58,56,46,72
1115039,17,28,1996,6,female,279,783,285,102,235,86,96,16,139
1729186,24,7,1989,9,female,1532,726,244,104,507,76,410,28,97
1306228,21,23,1992,11,male,675,722,541,101,117,101,102,0,15
1098179,19,20,1994,7,female,547,737,238,101,177,101,89,0,88
1440251,23,16,1990,5,female,607,764,429,104,236,104,210,0,26
1315409,20,29,1993,10,female,500,743,498,108,51,7,15,101,36
1320366,16,17,1997,6,female,580,725,623,106,106,20,73,86,33
1407918,17,2,1996,5,female,560,802,499,105,149,40,50,65,99
1715021,18,12,1995,3,male,644,770,674,106,388,103,139,3,249
1284145,18,23,1995,7,male,513,825,254,108,37,108,23,0,14
1029497,20,20,1993,2,female,306,729,370,109,849,109,705,0,144
2104354,19,26,1994,6,male,624,823,643,113,122,105,104,8,18
1461217,31,8,1982,6,male,497,732,657,117,17,0,13,117,4
1463614,25,28,1988,4,male,654,736,229,118,302,19,152,99,150
1312504,25,10,1988,9,male,1005,781,458,117,377,41,176,76,201
1979221,21,20,1992,2,female,381,743,636,118,60,111,32,7,28
1063832,15,5,1998,12,female,424,734,376,115,151,84,125,31,26
1367571,16,11,1997,9,female,437,746,409,119,65,119,38,0,27
1168471,19,9,1994,5,male,533,790,395,114,105,114,55,0,50
1094293,19,1,1994,11,male,303,734,509,124,192,65,151,59,41
1345631,21,9,1992,9,male,729,756,214,121,453,79,303,42,150
1446003,24,20,1989,12,male,396,759,737,121,6,119,5,2,1
1324144,18,18,1995,7,female,690,803,351,123,218,119,107,4,111
1421198,21,9,1992,6,female,1667,772,454,120,308,119,220,1,88
1369947,18,19,1995,2,female,327,807,631,120,541,120,526,0,15
1838405,15,3,1998,4,male,699,725,612,130,133,16,64,114,69
1808179,15,16,1998,1,female,783,813,293,129,565,92,398,37,167
2045173,27,21,1986,4,female,1046,773,491,125,311,64,113,61,198
2183101,29,29,1984,3,female,722,743,473,129,505,46,434,83,71
2155468,21,24,1992,4,male,583,798,506,129,47,129,23,0,24
1633380,22,28,1991,10,female,833,745,480,125,29,125,15,0,14
1045786,26,14,1987,9,male,412,742,522,130,80,130,57,0,23
1189380,20,1,1993,11,male,1343,729,460,131,68,23,26,108,42
1704979,16,17,1997,12,male,439,829,419,136,443,36,300,100,143
1237861,20,25,1993,6,male,505,752,602,132,256,84,166,48,90
1207820,16,18,1997,5,female,242,817,635,136,74,136,62,0,12
2115278,18,4,1995,4,female,761,733,310,136,45,136,37,0,8
1577101,20,17,1993,7,male,869,799,521,131,83,131,75,0,8
1739446,21,23,1992,9,female,192,826,393,133,227,133,180,0,47
1840914,22,2,1991,4,male,502,760,670,141,68,0,31,141,37
1018771,25,17,1988,6,female,773,731,566,141,581,15,516,126,65
1635300,23,27,1990,3,female,467,756,462,139,162,39,98,100,64
1543501,29,19,1984,9,female,1229,729,421,140,100,33,35,107,65
1093968,17,20,1996,10,male,709,751,563,139,285,68,135,71,150
1466515,24,6,1989,8,female,1198,783,518,142,280,141,139,1,141
1752253,18,26,1995,7,female,265,788,459,143,54,143,43,0,11
1087643,18,23,1995,9,female,41,759,80,137,976,137,815,0,161
1524918,20,29,1993,5,female,637,757,271,147,205,61,131,86,74
2053589,18,25,1995,4,male,646,834,585,146,40,131,28,15,12
1925321,18,24,1995,7,male,199,785,691,144,22,144,17,0,5
2106002,16,5,1997,1,female,612,727,379,148,753,148,662,0,91
1486889,19,11,1994,11,female,477,730,457,145,306,145,192,0,114
1381859,16,25,1997,12,female,688,817,568,151,202,73,136,78,66
2123118,19,5,1994,1,female,519,722,376,151,509,64,210,87,299
1208384,19,13,1994,6,female,526,738,597,152,8,152,8,0,0
1904914,14,11,1999,1,male,391,766,703,162,17,10,9,152,8
1319971,19,22,1994,12,male,744,789,576,164,241,2,127,162,114
1337372,34,25,1979,12,female,799,813,392,164,110,0,36,164,74
1380956,35,6,1978,9,female,938,722,434,158,279,81,206,77,73
1682454,32,16,1981,5,female,409,805,485,161,309,145,119,16,190
1957657,13,13,2000,3,male,288,732,636,169,94,75,54,94,40
1395028,18,25,1995,11,male,310,734,650,169,243,82,123,87,120
1997728,20,13,1993,4,male,777,782,378,172,392,90,177,82,215
2156431,18,18,1995,11,female,314,727,136,169,16,156,10,13,6
2119405,19,5,1994,12,male,294,832,566,168,349,165,244,3,105
1934866,21,18,1992,11,male,512,778,644,168,97,168,79,0,18
1192319,19,29,1994,3,male,464,816,453,177,163,7,62,170,101
1140388,19,2,1994,5,male,559,739,449,178,163,53,99,125,64
1318181,19,22,1994,5,female,849,748,505,178,456,41,355,137,101
1098324,16,18,1997,11,female,342,791,140,173,225,171,173,2,52
2182517,18,16,1995,12,female,827,802,564,173,2113,161,1187,12,926
1143789,19,25,1994,6,male,470,789,352,175,404,131,126,44,278
2159962,19,23,1994,8,female,857,809,305,178,431,129,264,49,167
2082037,15,24,1998,2,female,535,834,393,177,107,177,89,0,18
1022436,21,18,1992,11,female,371,776,486,176,94,176,83,0,11
2049146,21,25,1992,3,female,338,801,381,181,88,181,74,0,14
2060213,15,5,1998,1,female,317,778,429,178,641,178,549,0,92
1917762,18,6,1995,1,female,522,785,299,173,427,173,407,0,20
2069810,27,16,1986,1,male,365,788,467,182,554,35,165,147,389
1855594,19,5,1994,8,male,556,748,560,190,37,186,24,4,13
1506505,36,5,1977,5,male,87,819,797,186,263,172,244,14,19
1443936,21,17,1992,8,male,1494,811,301,190,324,170,271,20,53
1248119,19,3,1994,4,male,412,814,697,187,54,187,26,0,28
1470180,17,14,1996,2,male,82,789,769,184,132,184,112,0,20
1751793,19,8,1994,8,male,557,819,626,188,121,188,99,0,22
1467983,19,8,1994,11,female,130,800,175,189,332,189,307,0,25
1716501,33,26,1980,4,female,318,763,408,185,282,185,260,0,22
1827501,13,18,2000,2,female,734,801,466,194,159,31,109,163,50
1984009,18,22,1995,7,female,528,725,328,192,221,12,102,180,119
1178280,16,21,1997,3,female,178,756,89,191,451,36,336,155,115
1782734,14,28,1999,2,female,504,767,328,193,65,167,40,26,25
1534925,24,24,1989,6,male,698,737,196,199,111,189,54,10,57
2078722,32,12,1981,10,male,1688,774,241,199,104,165,78,34,26
1559059,15,23,1998,3,female,570,744,309,199,194,191,139,8,55
1020248,18,4,1995,3,female,1575,732,450,195,746,176,372,19,374
1895147,15,2,1998,5,male,395,798,700,197,68,197,58,0,10
2123400,21,30,1992,11,male,316,725,639,199,87,199,84,0,3
1346221,25,4,1988,3,male,628,759,452,196,74,196,70,0,4
1297711,27,1,1986,9,female,887,823,377,194,791,194,632,0,159
1143073,20,16,1993,12,female,952,766,276,209,1162,3,555,206,607
1038967,21,13,1992,5,female,1674,776,411,202,452,55,198,147,254
1835792,23,20,1990,1,female,681,810,227,209,525,85,184,124,341
1231732,15,25,1998,7,female,354,750,244,211,214,157,156,54,58
1612289,18,4,1995,4,female,778,793,581,204,315,196,217,8,98
1396599,21,23,1992,9,male,1047,823,667,201,43,200,30,1,13
1724877,15,29,1998,8,male,344,771,391,208,31,208,22,0,9
1702597,19,12,1994,6,female,527,743,378,217,255,134,98,83,157
1851837,18,11,1995,9,female,718,748,323,218,613,151,220,67,393
1792898,23,7,1990,1,female,1517,759,310,216,103,197,66,19,37
1619133,16,2,1997,8,male,589,817,536,214,103,214,74,0,29
1519428,19,4,1994,4,male,408,751,621,220,129,220,93,0,36
1104250,20,17,1993,10,male,463,725,377,219,208,219,135,0,73
1030673,17,18,1996,2,male,805,804,575,231,249,160,140,71,109
2043703,18,27,1995,6,female,908,763,480,231,165,159,106,72,59
1347742,15,11,1998,2,male,168,822,429,223,360,48,201,175,159
2154376,18,7,1995,7,male,725,801,473,230,575,73,259,157,316
1823458,19,3,1994,10,female,512,786,237,232,595,61,308,171,287
1057340,22,28,1991,4,male,692,780,192,229,892,130,650,99,242
1116636,14,1,1999,1,male,150,832,651,230,29,200,23,30,6
1162698,19,16,1994,4,female,792,785,303,233,76,169,47,64,29
1113815,19,23,1994,1,male,493,811,708,229,215,217,180,12,35
2125472,42,4,1971,10,female,103,762,646,243,201,95,82,148,119
1582686,21,28,1992,3,female,394,804,231,234,568,54,268,180,300
1924042,21,19,1992,1,female,1376,740,466,236,92,206,57,30,35
1207172,21,8,1992,8,male,637,725,581,243,326,214,247,29,79
1856272,19,6,1994,1,female,528,728,440,237,442,189,300,48,142
1651473,33,5,1980,12,male,718,733,540,239,353,239,294,0,59
2100928,39,25,1974,7,female,560,775,159,256,213,45,125,211,88
1731671,34,11,1979,6,female,633,742,557,247,137,176,34,71,103
1167405,20,3,1993,6,female,723,801,331,260,435,64,66,196,369
1857803,21,4,1992,1,male,421,797,711,247,181,238,139,9,42
1925115,23,14,1990,8,female,658,829,681,260,256,255,195,5,61
1198991,21,14,1992,2,male,1715,811,491,247,485,193,279,54,206
1063830,26,17,1987,10,female,1110,766,498,255,808,195,439,60,369
1671301,18,30,1995,1,female,633,724,522,261,437,173,134,88,303
1221604,18,1,1995,9,female,230,729,142,267,410,238,251,29,159
2102625,18,19,1995,10,female,1280,725,167,266,1136,244,321,22,815
1125250,36,1,1977,1,male,448,797,260,274,19,274,12,0,7
1371716,18,18,1995,6,male,365,807,613,271,138,271,72,0,66
1687260,23,5,1990,7,female,179,738,499,273,75,273,60,0,15
1030114,22,21,1991,7,female,1588,777,461,277,339,167,259,110,80
1685286,39,7,1974,9,female,1754,826,264,292,1818,181,856,111,962
1521848,26,2,1987,10,female,1521,749,410,285,281,247,187,38,94
1846018,25,1,1988,1,male,193,748,474,287,221,287,170,0,51
1707331,16,10,1997,5,female,271,723,164,278,562,278,483,0,79
2143949,20,13,1993,12,female,560,750,328,280,496,280,408,0,88
2080858,19,13,1994,9,female,351,780,139,290,1058,290,856,0,202
1378473,15,16,1998,10,male,247,722,599,308,374,44,233,264,141
1382275,20,6,1993,8,female,179,761,39,299,217,9,143,290,74
1428084,19,17,1994,4,male,1203,819,309,293,275,162,116,131,159
1914937,18,28,1995,10,male,467,803,648,301,312,268,191,33,121
1900481,16,30,1997,3,female,222,812,164,303,1321,302,836,1,485
1543924,14,9,1999,6,female,251,831,617,300,138,300,108,0,30
1867530,18,12,1995,12,female,728,750,404,303,267,303,236,0,31
1122721,16,10,1997,4,male,673,796,581,296,496,296,287,0,209
1965568,20,7,1993,12,female,484,741,353,314,37,1,6,313,31
1290824,19,6,1994,10,male,894,800,255,313,184,0,36,313,148
1948481,17,6,1996,9,male,424,755,461,316,246,35,149,281,97
1251873,19,11,1994,9,female,216,768,525,310,462,46,263,264,199
1690621,29,7,1984,3,female,842,753,333,315,1062,42,448,273,614
1257648,16,15,1997,12,female,1007,817,447,318,510,109,194,209,316
1164855,20,28,1993,7,female,690,806,499,309,390,279,167,30,223
1776290,19,14,1994,9,female,640,764,398,318,585,261,299,57,286
1517799,19,21,1994,4,female,382,722,327,323,176,323,146,0,30
1663115,25,13,1988,7,female,535,742,242,318,214,318,197,0,17
1461721,19,3,1994,12,female,279,783,581,317,620,317,488,0,132
1955403,18,21,1995,8,male,1253,776,569,340,672,28,251,312,421
1365559,22,4,1991,8,male,623,772,471,345,195,88,93,257,102
1982488,20,5,1993,11,female,1576,772,518,336,400,74,129,262,271
2131144,19,6,1994,3,male,510,817,653,341,313,172,55,169,258
1702766,23,21,1990,3,male,529,827,669,331,845,105,276,226,569
1459252,35,3,1978,4,male,1394,790,673,330,405,283,309,47,96
1020389,24,7,1989,4,female,626,771,456,332,1082,327,714,5,368
1803394,33,1,1980,2,male,547,803,626,344,193,344,131,0,62
1920256,17,1,1996,1,male,134,740,627,330,314,330,296,0,18
1516920,26,14,1987,1,female,533,734,525,343,997,343,878,0,119
1823587,15,12,1998,8,female,577,830,560,351,193,0,71,351,122
1347844,21,5,1992,1,female,68,807,430,365,2153,46,1014,319,1139
1657048,18,7,1995,4,female,299,766,269,355,478,287,239,68,239
2097990,15,21,1998,8,male,512,833,667,364,79,362,58,2,21
1167209,16,1,1997,1,male,260,798,720,357,190,357,132,0,58
1773766,19,3,1994,8,male,317,789,653,352,143,352,104,0,39
1104037,21,9,1992,7,male,472,739,367,360,115,360,99,0,16
1951131,37,20,1976,12,female,637,796,551,368,97,368,63,0,34
1231910,18,24,1995,9,female,396,833,671,382,89,244,71,138,18
1485883,20,28,1993,3,male,364,783,599,380,417,227,292,153,125
1965989,20,9,1993,4,female,570,783,337,392,597,264,308,128,289
1194657,21,26,1992,3,male,462,771,429,383,747,192,553,191,194
1347288,38,13,1975,1,female,1102,739,415,379,780,222,445,157,335
1974946,18,25,1995,12,female,414,725,589,375,418,318,263,57,155
2055156,22,28,1991,12,female,1056,754,298,384,485,342,292,42,193
1128832,17,10,1996,8,female,186,752,533,375,372,375,229,0,143
1739227,23,1,1990,1,male,472,739,628,383,444,383,438,0,6
1476069,14,29,1999,6,female,369,753,563,414,122,33,18,381,104
1417982,18,4,1995,10,female,495,814,665,412,192,147,84,265,108
2000477,39,27,1974,2,female,816,722,346,395,274,170,110,225,164
1322004,22,31,1991,3,female,1113,810,530,416,212,411,193,5,19
1047028,22,3,1991,5,female,253,809,281,405,376,302,223,103,153
1621774,22,4,1991,1,male,896,816,699,407,333,407,281,0,52
1185734,23,21,1990,7,female,599,831,486,413,441,413,202,0,239
1322783,16,13,1997,5,female,103,801,415,409,1737,409,1334,0,403
1587953,14,18,1999,4,female,280,831,215,430,228,22,133,408,95
1321567,15,8,1998,11,female,511,782,469,429,368,267,191,162,177
2161632,15,21,1998,2,female,824,795,324,441,537,239,325,202,212
1343749,18,6,1995,9,female,357,825,655,442,610,267,419,175,191
1915661,23,30,1990,5,female,991,754,435,435,487,283,124,152,363
1273436,19,11,1994,3,male,538,736,425,442,688,302,383,140,305
2042075,20,12,1993,6,female,719,753,559,447,431,332,248,115,183
1754865,20,19,1993,9,female,1723,755,344,426,477,393,302,33,175
1736166,28,24,1985,5,female,775,823,494,446,556,406,303,40,253
2170423,19,11,1994,8,female,306,723,364,428,642,409,350,19,292
1894728,33,1,1980,1,male,807,802,565,440,698,333,391,107,307
1231366,19,5,1994,1,male,634,765,497,424,290,424,240,0,50
2182507,38,17,1975,8,female,329,768,250,444,414,444,370,0,44
1480383,16,28,1997,10,female,497,805,611,481,217,87,127,394,90
1224015,23,23,1990,6,male,306,738,585,475,770,80,252,395,518
1281598,20,7,1993,4,male,597,812,661,458,223,213,127,245,96
1215945,15,2,1998,2,male,900,723,440,469,595,379,318,90,277
1789691,16,29,1997,9,female,446,822,380,480,343,373,101,107,242
1558835,17,5,1996,8,female,408,809,609,459,635,337,320,122,315
1755870,18,14,1995,7,female,622,768,153,476,509,443,350,33,159
1493623,23,30,1990,6,female,453,735,423,461,1237,427,498,34,739
1973803,18,19,1995,10,female,332,787,436,454,333,454,294,0,39
1533740,26,14,1987,4,female,345,778,593,470,452,470,250,0,202
1277749,23,31,1990,10,male,631,797,711,471,1569,471,977,0,592
2106450,30,1,1983,1,male,227,755,123,464,1021,464,900,0,121
1598201,35,2,1978,11,female,133,804,443,477,901,477,489,0,412
1327205,19,28,1994,12,female,172,746,649,501,856,380,285,121,571
1827518,19,4,1994,5,female,617,735,359,514,1409,482,869,32,540
1966588,29,18,1984,9,female,708,814,77,498,1101,414,341,84,760
2026409,16,10,1997,9,male,639,798,612,496,241,494,170,2,71
1178430,18,22,1995,8,female,423,759,213,512,773,509,449,3,324
1947852,23,9,1990,9,male,505,817,770,501,89,501,78,0,11
2186904,27,9,1986,8,male,961,738,456,486,122,486,109,0,13
2058817,31,14,1982,7,female,1550,828,161,488,253,488,166,0,87
1048824,18,11,1995,3,male,963,729,419,485,328,485,309,0,19
1364155,25,1,1988,1,female,130,744,55,497,1698,497,1348,0,350
2015281,14,1,1999,11,female,670,825,516,528,669,372,425,156,244
1794260,17,27,1996,8,female,623,760,402,535,491,159,328,376,163
1880980,19,27,1994,7,male,393,741,554,520,371,187,314,333,57
1440166,22,30,1991,4,female,653,825,206,549,686,171,462,378,224
1882269,16,16,1997,10,female,637,833,450,549,1387,170,577,379,810
2071231,17,27,1996,4,female,39,725,483,525,1638,113,840,412,798
2174191,20,2,1993,11,female,384,730,550,520,50,470,38,50,12
1907884,18,11,1995,4,male,1219,735,258,560,775,553,720,7,55
1495098,18,28,1995,6,male,190,802,576,552,445,515,318,37,127
1404332,19,16,1994,6,female,1394,804,172,528,348,391,195,137,153
1886864,18,11,1995,6,male,114,754,511,529,935,487,837,42,98
2027667,18,21,1995,7,male,465,792,689,558,1228,494,952,64,276
1871081,26,17,1987,9,male,424,794,602,554,1055,523,893,31,162
1408644,19,20,1994,2,female,588,770,518,579,701,163,333,416,368
1395478,18,20,1995,9,female,258,737,132,576,1362,382,990,194,372
2150556,17,4,1996,4,female,651,809,615,582,263,481,224,101,39
2039547,18,18,1995,1,female,316,737,541,590,484,590,437,0,47
2152114,19,7,1994,1,female,660,818,443,571,486,571,370,0,116
2168089,22,20,1991,4,female,551,774,262,637,753,94,294,543,459
1999752,24,25,1989,4,male,636,751,617,619,458,306,284,313,174
1706044,21,23,1992,11,female,589,821,319,643,1585,200,674,443,911
1981134,22,7,1991,9,male,548,774,291,662,1225,319,468,343,757
2190599,20,14,1993,7,female,1124,724,354,660,852,540,726,120,126
1685623,21,2,1992,4,male,196,774,546,610,550,595,343,15,207
1765643,23,9,1990,5,female,100,779,664,658,549,639,280,19,269
1969298,37,21,1976,5,female,654,739,147,646,1705,500,597,146,1108
1453471,29,24,1984,6,female,693,729,152,619,822,619,627,0,195
1083984,19,27,1994,4,female,571,759,582,696,287,66,110,630,177
1007756,19,10,1994,9,female,452,733,222,711,562,442,301,269,261
1869752,16,12,1997,2,female,183,808,255,694,744,677,623,17,121
1167374,18,16,1995,8,male,426,831,587,698,1908,698,1499,0,409
1568788,17,19,1996,8,male,172,793,768,748,601,59,318,689,283
2154246,15,25,1998,1,female,839,821,470,762,155,428,56,334,99
2157042,20,5,1993,5,female,423,746,530,752,1087,321,547,431,540
1745327,23,21,1990,10,female,501,812,309,768,528,373,332,395,196
1390792,24,20,1989,8,male,161,824,632,727,722,390,438,337,284
2129676,42,3,1971,2,female,1439,769,386,732,791,431,125,301,666
1945430,14,6,1999,10,female,377,785,626,752,671,656,314,96,357
1350848,24,12,1989,6,female,1330,724,256,740,594,695,378,45,216
2158739,23,19,1990,2,male,485,825,744,794,75,794,62,0,13
1444628,16,25,1997,8,male,309,780,673,795,189,795,178,0,11
1285965,17,16,1996,4,female,362,817,499,783,425,783,258,0,167
1930667,23,16,1990,9,male,270,773,655,770,259,770,222,0,37
2090680,18,10,1995,10,male,310,802,361,746,2618,746,2241,0,377
2101049,30,26,1983,9,female,659,779,408,801,1467,98,539,703,928
1419518,20,10,1993,1,female,200,747,388,818,264,644,98,174,166
1401022,23,9,1990,12,male,226,745,251,853,1156,792,508,61,648
1199457,22,15,1991,9,female,459,817,127,857,1432,829,857,28,575
2109781,32,30,1981,9,female,504,732,527,803,3328,611,1698,192,1630
2112202,24,4,1989,2,female,233,747,419,869,961,868,484,1,477
1531056,23,21,1990,11,female,1223,808,405,847,1317,844,584,3,733
1419220,28,14,1985,11,male,371,801,670,871,222,871,200,0,22
1780565,19,10,1994,5,female,442,793,280,904,969,147,700,757,269
1377726,20,7,1993,1,female,1084,743,367,889,1823,172,646,717,1177
1642058,18,24,1995,2,female,1462,807,540,901,271,319,177,582,94
1212433,25,15,1988,4,female,553,765,525,905,404,398,133,507,271
1911539,15,17,1998,5,female,895,739,313,923,912,459,425,464,487
2147294,24,20,1989,4,female,639,745,170,930,845,591,294,339,551
1244961,26,19,1987,12,male,451,768,533,913,304,864,208,49,96
2050088,26,8,1987,10,female,629,817,475,911,293,897,265,14,28
1202263,15,18,1998,2,female,265,798,164,938,1061,767,555,171,506
1897401,19,19,1994,11,female,381,832,621,957,1258,836,756,121,502
1252927,32,3,1981,5,female,1261,824,335,937,607,911,258,26,349
2000040,17,1,1996,11,female,58,744,653,883,2034,794,1520,89,514
1913222,22,9,1991,4,female,614,749,444,969,750,967,505,2,245
2042631,17,26,1996,1,male,530,791,568,926,203,926,194,0,9
1155418,17,20,1996,1,female,402,776,127,901,441,901,376,0,65
1282967,20,25,1993,8,female,415,831,459,897,316,897,269,0,47
1945168,22,12,1991,6,male,416,757,722,905,524,905,263,0,261
1993481,36,16,1977,8,male,448,824,691,945,496,945,233,0,263
1260277,18,19,1995,9,female,623,761,513,899,558,899,462,0,96
1441616,27,2,1986,4,male,126,724,698,905,973,905,882,0,91
2018914,13,2,2000,2,female,332,826,495,1024,683,125,145,899,538
1220184,20,1,1993,7,male,893,748,471,1069,1454,2,655,1067,799
1513654,15,23,1998,12,female,317,735,265,1063,611,359,192,704,419
1143777,19,19,1994,3,female,592,749,309,987,1080,278,594,709,486
1222625,16,19,1997,10,female,1042,756,439,1078,1709,748,1012,330,697
1674584,17,14,1996,8,female,401,818,395,1016,261197,659,131244,357,129953
1866690,18,7,1995,1,female,208,766,340,1057,1925,459,580,598,1345
1762527,19,9,1994,2,female,250,735,329,1005,1056,878,781,127,275
1156238,23,8,1990,8,male,695,820,486,1078,92,1078,92,0,0
1432172,26,2,1987,3,female,322,723,62,1058,2872,1058,1728,0,1144
1834220,19,11,1994,11,female,462,808,445,1210,697,35,271,1175,426
1014219,21,28,1992,11,female,374,820,720,1288,686,678,523,610,163
1023232,17,15,1996,1,male,788,772,466,1194,943,594,397,600,546
2010401,20,10,1993,3,female,1278,829,544,1214,1839,484,1155,730,684
1737239,18,27,1995,3,female,1117,797,211,1246,278,1224,175,22,103
1777964,21,1,1992,7,female,634,787,329,1169,1777,944,1499,225,278
1620096,34,8,1979,8,female,340,725,519,1240,1927,1005,1438,235,489
1456056,19,6,1994,9,female,873,808,510,1160,179,1153,110,7,69
1255844,19,1,1994,6,female,1069,750,140,1260,1271,1249,1055,11,216
1325379,23,8,1990,4,male,449,793,439,1210,188,1210,72,0,116
1042126,14,3,1999,4,male,256,821,469,1185,573,1185,505,0,68
1641844,20,7,1993,5,female,380,796,333,1222,1311,1222,1128,0,183
2154974,17,12,1996,2,male,356,763,607,1387,562,0,231,1387,331
2165066,34,23,1979,7,female,969,728,527,1402,289,56,102,1346,187
1181061,14,28,1999,9,male,159,829,715,1335,1060,164,206,1171,854
1933472,18,5,1995,11,male,1161,815,584,1340,1031,180,372,1160,659
1422125,27,3,1986,5,female,1097,771,447,1396,1174,220,735,1176,439
2041163,14,28,1999,3,female,211,786,244,1441,650,970,445,471,205
1227971,14,9,1999,1,female,977,772,188,1414,1047,544,821,870,226
2155419,21,2,1992,8,female,216,806,374,1380,1679,276,1118,1104,561
2026244,15,3,1998,8,female,1168,734,464,1293,1260,968,800,325,460
1164305,16,7,1997,9,female,238,760,188,1404,1194,1237,637,167,557
2097682,17,16,1996,6,female,1151,767,386,1315,1182,1198,994,117,188
1444436,18,18,1995,3,female,303,751,473,1471,1184,1394,802,77,382
2053483,21,23,1992,12,male,219,834,680,1347,3020,1161,1850,186,1170
1970642,15,19,1998,11,male,689,730,270,1388,519,1382,205,6,314
2074097,15,1,1998,3,female,111,818,274,1570,2333,143,445,1427,1888
1368621,28,27,1985,5,female,513,787,446,1635,760,437,295,1198,465
1007094,35,6,1978,6,female,489,740,495,1713,809,1233,618,480,191
2157418,21,28,1992,12,male,920,795,373,1626,1744,965,399,661,1345
1007387,21,8,1992,10,female,842,752,421,1679,1252,898,492,781,760
1850997,34,13,1979,1,female,1025,770,377,1675,1586,630,460,1045,1126
1192287,17,29,1996,10,male,476,834,670,1643,112,1593,95,50,17
2117480,17,6,1996,6,male,396,807,597,1838,736,1819,578,19,158
1835116,19,8,1994,8,male,406,744,471,1628,353,1417,285,211,68
1997959,23,13,1990,2,female,489,740,57,1551,548,1350,525,201,23
1453561,27,7,1986,8,male,527,804,719,1685,544,1456,427,229,117
1102930,17,5,1996,11,female,239,743,131,1694,1434,1502,930,192,504
2138601,16,9,1997,3,female,174,733,140,1583,1076,1196,464,387,612
1905121,18,15,1995,3,male,348,735,530,1752,1273,1637,566,115,707
1220547,20,30,1993,11,female,626,812,364,1711,1251,1677,657,34,594
1586826,16,22,1997,9,female,200,737,507,1628,436,1628,294,0,142
1327814,17,28,1996,8,male,493,780,618,1586,642,1586,431,0,211
1559207,20,29,1993,1,male,357,774,474,1830,680,1830,355,0,325
1129963,27,5,1986,5,male,108,783,641,1869,1788,1869,1708,0,80
1571469,18,11,1995,6,female,287,763,389,1936,2643,261,981,1675,1662
2026591,13,4,2000,3,female,130,817,290,2037,2484,1064,1890,973,594
1851094,14,24,1999,6,female,414,774,397,1952,1076,1541,444,411,632
1255913,15,2,1998,1,male,237,767,597,1919,595,1686,479,233,116
1498975,15,17,1998,5,female,296,756,353,1944,702,1424,377,520,325
2094366,17,24,1996,9,male,325,831,584,2100,723,1954,576,146,147
1859564,20,29,1993,11,female,378,722,454,2227,899,2169,628,58,271
1705214,22,16,1991,8,female,531,796,631,2270,1083,1832,832,438,251
1980431,18,26,1995,6,female,717,809,354,2015,1459,1851,446,164,1013
1123706,18,12,1995,3,female,558,767,360,1994,3495,1623,2485,371,1010
1284102,26,26,1987,4,female,322,739,557,1979,781,1979,555,0,226
1124035,17,15,1996,2,female,173,792,391,1976,1768,1976,1574,0,194
1769001,27,17,1986,6,female,62,830,714,2211,1527,2211,1150,0,377
1149300,24,7,1989,3,female,2,834,104,2169,5404,2169,1520,0,3884
2011687,16,20,1997,1,female,478,778,270,2504,514,111,297,2393,217
1506794,18,16,1995,9,female,788,744,459,2576,947,66,212,2510,735
1561685,21,13,1992,9,female,390,824,537,3556,2116,479,1009,3077,1107
1004475,22,4,1991,2,male,474,729,569,2747,643,141,505,2606,138
1652451,19,7,1994,10,female,321,773,617,3114,439,1004,284,2110,155
1718830,28,21,1985,12,female,847,753,464,2612,1272,908,476,1704,796
1804650,13,17,2000,9,female,40,826,442,2507,1873,1179,1183,1328,690
1452932,17,22,1996,3,female,1312,729,341,2669,2998,1915,1420,754,1578
1262968,19,21,1994,2,male,497,812,624,2581,2674,1142,1026,1439,1648
1780277,25,10,1988,2,female,809,764,312,3326,4551,2045,2558,1281,1993
1953841,24,18,1989,4,male,404,820,696,2731,305,2659,266,72,39
1790181,16,2,1997,11,female,464,754,362,2944,1289,2904,1010,40,279
1477333,18,16,1995,12,female,769,759,357,2418,678,2386,595,32,83
2172403,20,23,1993,9,female,703,751,516,3345,2029,2744,624,601,1405
1254469,39,28,1974,7,female,321,767,365,3191,1250,3134,652,57,598
1488669,15,25,1998,11,female,648,808,465,3504,3023,3246,1822,258,1201
1639000,14,2,1999,4,female,273,833,425,2613,2112,2321,1543,292,569
1148615,18,26,1995,11,male,331,818,436,2383,1894,2353,1349,30,545
1723806,20,26,1993,11,male,871,755,373,2826,2478,2430,1675,396,803
1926242,22,6,1991,2,female,25,750,401,2997,1874,2868,1251,129,623
1718591,21,4,1992,3,male,170,743,560,2453,881,2453,795,0,86
1655486,23,10,1990,10,male,361,727,533,2960,756,2960,604,0,152
1142566,19,8,1994,1,male,286,739,480,3257,3037,3257,1809,0,1228
1445913,28,6,1985,6,female,51,773,170,3542,2366,3542,1959,0,407
2163713,17,5,1996,10,female,73,775,403,6976,2736,0,683,6976,2053
1513900,17,17,1996,9,male,242,813,504,9965,8042,534,3133,9431,4909
1930221,18,27,1995,1,female,182,730,499,5652,3486,1088,3241,4564,245
1002588,17,11,1996,10,female,346,777,434,14050,8212,3423,5041,10627,3171
1475433,18,6,1995,12,female,159,784,571,5001,7467,2952,4911,2049,2556
1715584,27,23,1986,10,female,2047,830,546,4599,4033,3153,1095,1446,2938
1369400,15,2,1998,10,female,780,725,317,4596,1310,3650,766,946,544
1984566,18,22,1995,4,female,1288,808,353,4179,2318,3704,1184,475,1134
1664534,17,4,1996,10,female,164,734,46,6403,6146,6212,5174,191,972
1087348,19,5,1994,2,female,189,746,525,3887,2069,3858,1764,29,305
1889021,20,10,1993,10,male,330,801,485,4270,2195,4249,1717,21,478
1668072,25,1,1988,7,male,542,798,436,10773,2204,10748,2108,25,96
1076331,15,30,1998,12,female,420,811,453,3943,4443,3937,2250,6,2193
1092280,21,2,1992,2,female,390,726,380,5326,900,5326,747,0,153
1234286,23,7,1990,11,male,372,741,517,5438,1438,5438,1183,0,255
1393420,23,25,1990,10,male,430,742,587,3955,1726,3955,1361,0,365
1274062,24,1,1989,1,male,336,747,594,4402,1484,4402,830,0,654
1707261,24,27,1989,7,male,359,729,610,3809,698,3809,651,0,47
1457525,25,10,1988,10,male,130,810,490,4847,1816,4847,1699,0,117
1595110,19,29,1994,11,female,686,733,302,4219,4532,4219,4166,0,366
1614581,33,25,1980,11,female,275,732,35,6724,4264,6724,3442,0,822
1061101,28,28,1985,9,female,329,915,805,103,61,101,37,2,24
1216466,14,16,1999,7,male,318,950,783,104,202,83,160,21,42
1943829,18,26,1995,7,male,786,978,387,101,136,101,92,0,44
1796297,39,15,1974,11,male,1462,956,579,106,41,0,18,106,23
1564041,18,17,1995,4,male,539,994,222,107,45,35,26,72,19
1865678,21,28,1992,6,female,658,838,344,105,75,40,47,65,28
1232748,26,18,1987,9,female,1545,898,252,107,269,71,137,36,132
1143020,21,14,1992,10,male,362,962,772,105,116,103,103,2,13
1163324,21,8,1992,7,female,134,961,455,106,701,88,556,18,145
1933431,15,22,1998,7,female,356,959,584,109,41,109,17,0,24
1869862,20,8,1993,3,male,359,902,668,105,57,105,51,0,6
1055099,18,7,1995,9,female,110,917,720,109,223,109,156,0,67
2072942,20,4,1993,10,female,297,877,242,110,768,1,482,109,286
1927632,22,2,1991,8,female,1074,900,479,111,182,67,72,44,110
2018681,17,7,1996,11,female,448,950,377,112,103,112,86,0,17
1366972,17,9,1996,10,male,599,936,798,112,69,112,60,0,9
1663333,16,10,1997,12,female,535,987,358,114,130,7,32,107,98
1482989,17,4,1996,9,male,1407,946,165,119,361,2,100,117,261
1234798,18,1,1995,4,female,159,909,373,117,206,82,178,35,28
2166804,19,1,1994,5,male,574,890,733,119,762,44,355,75,407
1545903,16,11,1997,8,male,406,909,634,117,169,95,90,22,79
1462427,32,16,1981,10,male,284,908,602,119,39,119,30,0,9
2157205,18,17,1995,1,female,473,932,475,116,87,116,68,0,19
1561560,24,13,1989,12,male,1875,950,703,119,247,119,169,0,78
2156188,19,10,1994,12,female,805,971,184,122,221,78,210,44,11
1972221,40,19,1973,1,male,503,915,608,121,415,44,262,77,153
2071627,18,18,1995,3,male,397,891,785,123,47,123,23,0,24
1122158,15,21,1998,10,female,327,956,581,124,256,124,142,0,114
1864924,19,5,1994,1,male,829,880,730,129,169,13,45,116,124
2084975,15,10,1998,6,female,273,901,279,130,339,47,201,83,138
1825611,20,10,1993,9,female,930,854,270,130,372,103,277,27,95
1883062,21,18,1992,8,male,604,916,423,130,24,130,23,0,1
1220138,24,17,1989,7,male,1360,956,711,127,29,127,25,0,4
1699018,19,26,1994,6,male,527,920,504,128,100,128,65,0,35
1463533,24,25,1989,2,male,340,890,338,126,266,126,126,0,140
1688807,14,7,1999,12,female,296,945,306,132,110,64,35,68,75
1876896,15,19,1998,11,female,392,965,180,135,493,56,225,79,268
1516320,18,24,1995,10,male,1441,876,366,132,322,66,173,66,149
1602681,25,7,1988,12,male,695,927,576,132,0,132,0,0,0
1684354,27,6,1986,7,female,1675,920,117,134,71,134,60,0,11
1571968,20,3,1993,3,female,483,950,169,133,306,133,196,0,110
1346524,18,11,1995,1,male,179,899,194,138,508,67,257,71,251
2180356,20,11,1993,9,female,349,957,113,143,1245,79,243,64,1002
1881220,21,8,1992,3,male,734,991,499,138,676,61,540,77,136
1675019,38,28,1975,2,female,1327,898,522,143,98,126,53,17,45
1690487,17,3,1996,3,male,565,928,650,137,515,101,462,36,53
1503512,19,1,1994,9,male,122,938,167,143,1196,123,457,20,739
2181149,28,11,1985,11,female,1349,874,553,137,324,130,172,7,152
1909262,21,18,1992,1,female,368,902,153,138,221,138,157,0,64
1918947,20,14,1993,2,female,940,908,434,146,79,71,50,75,29
1875765,25,6,1988,2,male,284,986,234,144,281,53,204,91,77
1104584,23,29,1990,9,male,426,848,723,148,382,148,284,0,98
1989048,19,8,1994,11,male,181,937,389,155,57,2,8,153,49
2012562,16,10,1997,8,female,355,969,770,153,201,113,115,40,86
1179776,21,27,1992,5,male,1117,968,555,151,414,146,310,5,104
2142499,19,17,1994,10,male,188,913,773,155,77,155,53,0,24
1170109,23,14,1990,2,male,485,873,791,154,58,154,55,0,3
1866594,20,27,1993,9,male,371,867,793,163,160,63,66,100,94
1926744,22,2,1991,4,female,438,894,531,160,50,160,36,0,14
1976706,14,24,1999,10,female,241,846,54,162,239,162,209,0,30
1376567,16,18,1997,8,female,373,930,817,162,297,162,150,0,147
1864238,22,29,1991,9,male,809,975,736,164,276,164,245,0,31
1952598,23,6,1990,5,male,650,941,594,160,1041,160,677,0,364
1827559,20,6,1993,7,female,682,956,635,172,122,123,73,49,49
1729275,19,27,1994,10,female,985,843,520,169,417,98,125,71,292
1502580,14,11,1999,12,female,83,961,158,167,1246,139,595,28,651
1433333,18,29,1995,8,female,429,868,417,169,487,151,435,18,52
1545166,23,14,1990,1,male,263,909,244,170,638,168,450,2,188
1120951,19,10,1994,9,male,598,927,797,175,26,12,15,163,11
1312518,18,21,1995,1,female,561,883,303,177,252,120,97,57,155
1702102,18,8,1995,8,female,643,970,682,179,422,109,255,70,167
1900471,18,4,1995,10,male,530,991,330,181,685,80,358,101,327
1704087,20,15,1993,12,male,345,850,757,174,291,125,183,49,108
1252092,24,15,1989,12,female,1543,906,157,179,351,125,112,54,239
2134091,20,1,1993,10,female,383,958,444,180,70,157,53,23,17
1454214,15,19,1998,11,male,477,893,837,180,201,149,121,31,80
1674131,17,18,1996,7,female,858,835,386,178,124,159,74,19,50
1673985,20,16,1993,1,male,674,892,734,175,561,128,333,47,228
1285873,23,18,1990,9,male,777,869,776,175,100,175,87,0,13
1464830,31,15,1982,6,female,668,905,748,179,840,179,633,0,207
2116635,16,5,1997,7,female,671,890,281,186,199,24,53,162,146
1693988,25,1,1988,5,male,558,979,704,185,82,115,63,70,19
1733983,17,20,1996,4,female,460,866,574,183,422,100,274,83,148
1588587,21,21,1992,11,male,218,919,260,184,387,112,172,72,215
1861466,15,17,1998,6,female,268,913,408,186,657,163,519,23,138
1039318,22,28,1991,5,female,477,930,703,187,322,166,130,21,192
1043240,15,15,1998,7,male,688,887,736,186,27,186,25,0,2
1728595,24,10,1989,10,female,1595,899,352,190,221,190,175,0,46
1650468,17,22,1996,5,male,671,839,565,193,223,190,76,3,147
1117841,16,2,1997,3,female,525,854,426,192,339,154,188,38,151
1154245,26,9,1987,9,female,684,867,756,200,252,199,189,1,63
1193653,16,1,1997,5,male,567,993,765,192,146,192,84,0,62
1438274,18,24,1995,11,male,489,845,600,193,414,193,322,0,92
1070774,17,1,1996,8,female,293,881,574,204,394,97,243,107,151
1882253,14,10,1999,4,female,349,866,669,202,827,202,530,0,297
1502339,17,8,1996,10,male,153,861,716,204,1058,204,984,0,74
1906911,20,1,1993,8,female,363,993,453,203,636,203,610,0,26
1776428,20,25,1993,1,female,677,988,565,213,327,0,154,213,173
1303577,17,16,1996,9,male,526,989,658,218,66,166,41,52,25
1279777,16,5,1997,3,female,578,963,287,216,80,216,68,0,12
1579502,25,4,1988,4,male,378,975,759,213,79,213,73,0,6
1636509,19,19,1994,4,male,709,972,795,213,166,213,145,0,21
1511187,17,11,1996,4,male,392,840,762,233,52,22,27,211,25
1900754,18,14,1995,9,male,654,974,640,233,87,59,63,174,24
2074452,33,9,1980,2,female,1410,865,215,224,270,224,183,0,87
1128394,23,27,1990,4,female,236,894,111,223,655,223,545,0,110
1858229,17,20,1996,5,male,429,887,571,238,10,68,4,170,6
2104751,21,13,1992,6,female,1473,982,253,244,92,148,41,96,51
1385601,21,30,1992,3,male,1534,865,608,245,183,100,126,145,57
1922831,15,15,1998,7,female,737,866,517,236,362,122,139,114,223
1692455,19,16,1994,11,male,442,925,825,237,375,137,93,100,282
2005340,18,17,1995,9,female,684,852,619,242,853,53,548,189,305
2140418,17,25,1996,10,female,555,907,345,244,104,179,46,65,58
1803519,16,14,1997,12,female,1336,984,392,239,364,173,294,66,70
1523121,16,18,1997,4,female,257,898,467,240,347,240,289,0,58
1356350,19,7,1994,11,female,247,904,704,237,516,237,390,0,126
1596476,16,25,1997,1,male,909,935,646,254,392,29,183,225,209
1655692,20,18,1993,10,male,423,972,863,257,137,115,52,142,85
1268436,15,5,1998,5,female,343,840,421,255,176,77,54,178,122
1726050,15,10,1998,7,female,454,888,575,258,271,158,40,100,231
1894921,23,29,1990,3,female,1641,853,283,260,167,119,19,141,148
2055620,14,21,1999,6,female,601,893,478,252,605,65,268,187,337
1309217,21,5,1992,8,male,693,885,406,249,408,170,209,79,199
1941191,38,25,1975,9,male,2027,993,587,256,240,191,142,65,98
2170012,23,11,1990,7,male,672,960,729,258,43,258,28,0,15
2090717,17,5,1996,6,male,1082,848,682,276,202,107,89,169,113
1213712,18,26,1995,4,female,898,853,422,261,228,189,142,72,86
2108097,19,11,1994,4,female,588,870,547,270,91,270,70,0,21
1441976,30,3,1983,12,female,243,845,172,264,294,264,254,0,40
1085907,19,27,1994,7,female,504,952,284,263,750,263,679,0,71
1714511,19,20,1994,9,male,421,843,763,262,864,262,709,0,155
1325458,16,26,1997,9,male,535,910,312,290,623,25,171,265,452
1268684,18,19,1995,5,male,503,841,338,284,239,183,143,101,96
1182093,22,30,1991,7,male,128,918,818,290,1197,134,871,156,326
1723684,29,6,1984,8,female,849,977,678,280,512,57,137,223,375
1509269,18,22,1995,8,male,891,895,299,278,93,275,62,3,31
1631822,16,18,1997,2,female,287,975,467,286,460,278,291,8,169
1879133,17,30,1996,9,male,406,898,716,285,117,285,29,0,88
1358236,19,11,1994,8,female,524,895,681,277,479,277,331,0,148
1307929,19,27,1994,10,male,945,886,383,287,434,287,324,0,110
2006369,21,13,1992,3,male,590,986,566,302,100,7,29,295,71
1757852,18,2,1995,8,male,281,973,461,295,157,177,105,118,52
2168964,18,11,1995,1,male,1022,980,601,296,461,203,156,93,305
1331204,15,17,1998,1,male,545,952,902,305,140,285,109,20,31
1497078,19,17,1994,10,female,1174,931,463,303,360,279,306,24,54
2105913,24,28,1989,3,female,2410,845,466,304,253,288,233,16,20
1729855,17,5,1996,9,male,589,925,762,308,472,225,338,83,134
1833030,18,9,1995,9,male,1671,931,148,298,524,225,398,73,126
1492710,17,12,1996,6,male,673,836,561,306,106,306,58,0,48
1080540,19,1,1994,3,male,566,933,714,295,83,295,34,0,49
1773597,19,7,1994,6,female,372,864,155,293,248,293,211,0,37
1694341,19,23,1994,8,male,554,841,613,308,362,308,166,0,196
1341966,23,23,1990,10,male,408,878,570,299,192,299,187,0,5
1759415,26,28,1987,10,male,160,903,823,302,287,302,286,0,1
1389722,18,30,1995,7,female,121,853,590,298,1635,298,1124,0,511
1710601,20,11,1993,8,female,570,923,293,293,476,293,431,0,45
1948852,23,25,1990,11,female,413,921,232,294,575,294,536,0,39
1129251,19,7,1994,10,female,454,894,550,317,606,13,250,304,356
1461049,24,5,1989,9,female,442,909,520,327,214,91,52,236,162
1945703,18,2,1995,4,female,618,881,577,314,777,65,202,249,575
1372655,23,11,1990,10,male,692,979,684,321,378,250,212,71,166
2096854,26,23,1987,3,female,1490,992,366,309,872,291,524,18,348
1151810,19,3,1994,8,female,841,879,576,324,200,324,129,0,71
1435344,31,23,1982,3,female,1229,979,707,321,214,321,186,0,28
1531763,23,26,1990,10,female,379,895,103,319,947,319,773,0,174
2163146,37,10,1976,4,female,237,851,488,337,921,53,321,284,600
1245028,26,20,1987,5,male,453,895,850,329,66,221,58,108,8
1107589,17,21,1996,2,female,668,880,511,343,249,178,112,165,137
1150444,21,8,1992,3,female,534,981,551,340,302,238,154,102,148
2158581,22,14,1991,5,male,566,854,760,333,178,333,168,0,10
1008673,14,11,1999,12,female,216,993,294,368,307,147,82,221,225
1179211,27,10,1986,10,male,636,903,623,366,405,103,233,263,172
1942019,20,18,1993,7,female,609,839,537,359,1077,142,632,217,445
2123961,22,26,1991,9,female,613,911,718,347,491,268,283,79,208
1230864,21,18,1992,1,female,638,994,536,351,56,351,38,0,18
1742855,18,19,1995,12,male,359,848,752,349,205,349,181,0,24
1276500,35,23,1978,10,male,670,971,837,354,214,354,127,0,87
1751445,27,7,1986,5,female,484,927,669,365,528,365,484,0,44
1407083,18,9,1995,6,female,1722,990,555,385,347,63,154,322,193
1224745,42,22,1971,5,female,379,865,500,389,426,99,110,290,316
1950258,17,24,1996,4,female,606,909,358,393,1030,302,633,91,397
1164571,16,20,1997,10,male,566,942,324,370,221,370,152,0,69
1520019,18,8,1995,3,male,982,909,671,375,183,375,119,0,64
1144646,16,6,1997,2,male,486,946,512,372,472,372,411,0,61
1229156,17,1,1996,6,female,699,870,747,400,363,28,274,372,89
1271178,18,4,1995,3,female,1538,872,408,395,738,117,271,278,467
2079691,19,27,1994,10,female,828,931,397,416,937,281,439,135,498
1842852,15,11,1998,5,female,588,894,404,396,162,389,39,7,123
1475109,17,17,1996,12,female,634,980,757,412,240,299,107,113,133
1649066,16,11,1997,8,male,264,873,496,404,90,315,73,89,17
1343588,17,25,1996,7,female,368,970,552,397,587,292,137,105,450
1482349,18,13,1995,3,female,915,994,528,419,597,362,313,57,284
1840565,21,5,1992,11,female,629,870,567,404,475,357,319,47,156
1312891,19,11,1994,11,female,464,841,545,415,861,378,652,37,209
2160507,23,5,1990,5,female,623,990,649,403,1516,363,612,40,904
2103109,28,1,1985,1,male,481,994,797,414,187,414,155,0,32
1818284,23,15,1990,12,female,560,970,478,445,980,237,611,208,369
1063782,16,5,1997,8,female,684,850,466,445,406,366,116,79,290
1624213,19,5,1994,9,female,653,850,566,444,474,420,420,24,54
1894144,18,30,1995,10,male,489,903,450,427,658,399,296,28,362
1680399,24,3,1989,7,male,365,917,851,422,224,422,213,0,11
1213604,17,11,1996,4,female,411,991,396,444,717,444,460,0,257
1632857,19,7,1994,6,female,342,911,721,473,167,23,83,450,84
1278207,16,25,1997,6,female,560,868,368,478,411,0,296,478,115
1965927,18,6,1995,8,female,324,868,489,466,545,51,153,415,392
1742015,36,3,1977,5,female,604,894,620,473,355,4,135,469,220
1922050,16,4,1997,6,female,692,885,607,457,731,247,515,210,216
1955571,16,1,1997,8,female,290,855,490,452,542,396,403,56,139
1211705,18,25,1995,10,male,816,966,808,473,369,428,195,45,174
1951460,18,6,1995,2,female,247,858,55,454,1154,452,1081,2,73
1088981,16,22,1997,1,female,683,992,473,470,761,470,516,0,245
2163048,17,9,1996,6,male,479,907,685,514,180,142,130,372,50
1343370,18,25,1995,7,female,161,966,253,505,555,166,371,339,184
1213086,19,1,1994,8,female,915,972,224,493,394,287,117,206,277
1158541,23,21,1990,9,female,465,858,648,500,658,104,329,396,329
1370493,18,19,1995,4,female,552,918,178,500,175,397,98,103,77
1052421,16,31,1997,10,female,986,864,739,514,419,410,122,104,297
1157162,18,13,1995,11,female,696,971,418,508,495,368,271,140,224
1915431,29,11,1984,12,female,703,975,491,518,413,474,265,44,148
1592352,17,13,1996,3,female,368,947,688,506,3982,487,3710,19,272
1941901,19,4,1994,6,female,1092,915,526,513,2922,454,1901,59,1021
1557125,42,20,1971,2,male,1545,929,225,485,768,389,675,96,93
1947595,16,3,1997,12,female,571,840,455,495,787,494,572,1,215
1666482,17,4,1996,10,female,472,844,538,496,297,496,265,0,32
1728468,19,28,1994,8,male,557,986,545,494,821,494,748,0,73
1726072,14,6,1999,8,female,840,970,574,524,41,2,8,522,33
1190474,19,7,1994,1,male,564,994,729,560,1914,109,782,451,1132
1835831,18,24,1995,3,female,613,918,356,555,659,160,225,395,434
1638580,25,26,1988,12,male,1549,941,360,533,431,393,195,140,236
1019712,20,20,1993,1,female,678,862,508,542,1376,533,548,9,828
1720052,20,7,1993,9,female,427,849,621,552,186,547,126,5,60
1059873,19,5,1994,5,male,664,977,879,529,53,529,43,0,10
1113495,17,27,1996,12,male,512,899,771,531,192,531,166,0,26
1547621,18,25,1995,12,male,533,966,851,523,232,523,188,0,44
1664001,24,8,1989,8,male,382,879,811,532,190,532,129,0,61
1010688,17,19,1996,11,female,693,943,248,539,659,539,543,0,116
2025624,18,10,1995,8,female,350,835,562,522,431,522,361,0,70
1561608,24,3,1989,9,male,1514,957,147,538,372,538,285,0,87
1475227,15,19,1998,5,female,469,886,125,537,1020,537,591,0,429
1212608,16,26,1997,4,female,465,970,750,528,1119,528,391,0,728
1761658,28,23,1985,5,male,645,958,630,568,423,74,405,494,18
1056758,19,3,1994,6,female,138,844,371,605,312,397,196,208,116
1429186,14,1,1999,1,female,1281,987,604,606,419,141,143,465,276
1359850,15,18,1998,7,male,281,974,768,563,579,397,226,166,353
1659509,18,2,1995,8,female,724,893,449,586,833,153,248,433,585
1331557,23,27,1990,5,female,1961,874,358,580,1406,415,792,165,614
1970597,19,27,1994,9,female,340,884,505,595,727,531,302,64,425
2034163,19,7,1994,3,male,620,983,827,576,102,576,101,0,1
1636974,18,20,1995,11,female,87,855,643,576,1620,576,1119,0,501
1038115,20,1,1993,8,male,474,921,857,644,75,4,59,640,16
1165674,16,18,1997,10,female,156,931,251,621,813,123,156,498,657
2018619,13,12,2000,1,female,449,930,524,634,802,402,273,232,529
1010317,15,11,1998,1,female,550,918,519,659,899,396,560,263,339
1280932,19,26,1994,8,female,1050,944,357,637,488,160,168,477,320
2065642,34,23,1979,11,female,567,969,598,648,595,345,276,303,319
2125725,16,6,1997,9,female,1267,935,550,620,1153,207,592,413,561
1406292,15,14,1998,3,female,291,904,446,618,828,589,706,29,122
1260308,22,24,1991,2,female,1841,993,375,635,865,593,399,42,466
2045879,15,14,1998,7,female,225,875,428,639,341,637,232,2,109
1850986,20,10,1993,8,male,349,917,709,620,191,618,140,2,51
1888742,17,1,1996,2,female,375,894,665,638,221,638,204,0,17
1615894,19,28,1994,9,male,381,982,900,649,341,649,205,0,136
1569589,21,2,1992,7,female,817,971,278,641,674,641,628,0,46
2074221,18,11,1995,11,female,579,887,594,715,580,75,215,640,365
1083779,21,26,1992,8,male,415,858,554,673,1742,44,1124,629,618
1415431,17,19,1996,3,female,651,933,462,685,560,316,294,369,266
1818067,18,31,1995,1,female,1418,952,393,680,500,198,232,482,268
1721211,18,14,1995,6,female,460,845,584,704,486,282,280,422,206
1082171,21,9,1992,12,male,1525,942,362,698,1037,174,635,524,402
1211942,22,3,1991,4,female,164,921,773,705,1067,198,488,507,579
1803152,41,17,1972,10,female,521,929,126,723,2378,340,880,383,1498
1840928,19,15,1994,5,female,1273,899,313,670,553,669,370,1,183
1672140,15,26,1998,1,female,357,931,266,667,412,667,261,0,151
2085123,20,22,1993,1,female,412,946,660,708,558,708,429,0,129
2136698,23,19,1990,5,male,341,959,437,681,676,681,283,0,393
1527302,17,6,1996,4,female,868,884,417,753,755,139,313,614,442
1242084,18,15,1995,8,female,820,856,501,749,671,35,416,714,255
1599384,14,5,1999,11,female,350,852,556,755,799,181,400,574,399
2156131,16,23,1997,8,female,515,967,255,762,599,222,411,540,188
1557179,17,8,1996,5,male,554,884,472,727,759,267,397,460,362
1682244,14,29,1999,12,female,16,847,558,737,1197,386,298,351,899
2097969,22,25,1991,9,female,367,977,692,754,5332,241,4356,513,976
1447423,25,5,1988,10,female,1771,966,527,781,1278,196,829,585,449
1389970,26,1,1987,2,female,549,966,127,781,1299,196,462,585,837
2135542,15,6,1998,8,female,400,942,519,763,397,667,165,96,232
2071084,16,22,1997,3,female,1420,930,466,753,708,681,452,72,256
1350465,18,17,1995,4,female,1153,936,351,739,533,675,512,64,21
2038354,19,4,1994,4,female,456,876,345,769,362,769,324,0,38
1891840,18,17,1995,2,male,590,966,686,816,1163,151,727,665,436
2008961,13,9,2000,2,female,15,869,569,825,3228,119,1638,706,1590
1832921,26,3,1987,1,male,365,875,646,866,266,188,156,678,110
1201823,15,13,1998,3,male,363,918,809,878,546,296,342,582,204
1638747,18,29,1995,11,male,606,866,573,843,926,584,797,259,129
1204594,21,13,1992,6,female,846,883,297,835,1563,248,639,587,924
1513531,22,14,1991,4,male,201,884,538,799,2637,470,1702,329,935
1403408,22,4,1991,8,male,339,993,592,815,1362,330,522,485,840
1478071,18,6,1995,11,female,375,896,699,812,492,729,243,83,249
1378663,18,6,1995,5,male,1418,884,319,861,1036,697,484,164,552
2190378,19,2,1994,8,male,316,927,769,827,638,808,441,19,197
1020542,21,19,1992,11,female,942,863,589,813,1152,630,826,183,326
1664451,21,28,1992,5,male,751,983,659,845,969,647,829,198,140
1983879,19,11,1994,9,female,250,940,360,802,1359,759,946,43,413
1415388,20,7,1993,1,female,386,918,456,865,2072,856,1602,9,470
1418291,27,11,1986,3,female,1990,901,250,851,2310,666,1336,185,974
1812862,15,6,1998,1,female,601,938,394,827,1225,824,1042,3,183
2143210,19,20,1994,8,female,170,922,721,975,1247,182,572,793,675
1601194,19,18,1994,10,female,492,887,581,969,449,591,249,378,200
1912842,14,17,1999,3,male,545,852,596,952,646,267,236,685,410
1959227,16,6,1997,7,female,654,915,367,888,749,423,605,465,144
1537568,18,21,1995,11,female,1002,866,352,931,1257,394,546,537,711
1310491,22,18,1991,1,female,712,897,545,922,1133,479,801,443,332
1242708,15,12,1998,10,female,543,959,676,942,1976,422,1223,520,753
1208816,19,29,1994,8,male,193,992,893,920,2395,366,514,554,1881
2137710,15,6,1998,3,female,390,862,298,889,807,726,784,163,23
1976629,18,5,1995,5,female,254,938,473,968,849,895,503,73,346
1745681,19,8,1994,5,male,458,948,780,925,676,789,536,136,140
2029860,20,2,1993,1,female,521,970,319,930,620,891,443,39,177
1815458,20,15,1993,3,female,601,874,112,947,917,889,374,58,543
1248988,24,10,1989,8,female,1120,851,460,908,1059,887,483,21,576
1952077,19,14,1994,9,male,319,908,485,965,2507,954,2072,11,435
2016439,16,16,1997,9,female,312,929,377,955,830,953,651,2,179
1763046,18,13,1995,10,male,414,979,575,961,969,955,619,6,350
1298011,20,26,1993,5,female,1650,885,462,908,637,904,368,4,269
1874930,15,22,1998,3,female,353,953,767,891,540,891,446,0,94
1961616,19,24,1994,10,male,398,884,836,880,456,880,302,0,154
1377138,24,22,1989,8,female,361,851,459,946,1966,946,1889,0,77
1467852,16,7,1997,8,female,664,987,736,1024,754,147,214,877,540
1578658,27,16,1986,5,female,176,877,598,1090,1573,197,728,893,845
1348644,39,7,1974,8,female,682,876,581,1009,1309,3,555,1006,754
1687994,19,21,1994,3,male,622,870,242,1039,2014,151,918,888,1096
1239286,20,25,1993,10,male,292,920,579,1088,1891,2,442,1086,1449
1130346,20,14,1993,7,female,788,838,462,1021,501,675,440,346,61
1072154,33,10,1980,9,female,2160,837,540,1005,337,670,236,335,101
1375876,20,29,1993,1,female,1096,886,510,1055,903,417,497,638,406
1754243,17,5,1996,7,female,323,853,435,1064,3148,287,959,777,2189
1759577,21,27,1992,5,female,1457,836,367,1050,486,845,305,205,181
1312095,15,22,1998,4,male,321,897,660,1075,967,1003,708,72,259
1505979,19,21,1994,1,female,398,934,460,1023,1240,806,655,217,585
1595387,19,30,1994,9,female,432,930,543,1083,1331,976,824,107,507
1648783,21,4,1992,12,female,698,995,540,1016,1021,753,504,263,517
1473690,16,6,1997,5,female,370,989,234,1037,1993,1024,1241,13,752
2167081,14,6,1999,9,female,420,883,631,1052,298,1046,170,6,128
1119495,19,30,1994,5,female,483,890,88,1031,1546,1029,523,2,1023
1085775,20,2,1993,2,female,596,888,508,1066,2021,1058,913,8,1108
1986553,22,23,1991,11,female,321,890,642,1081,1001,1081,965,0,36
1482065,15,24,1998,12,female,96,930,230,1148,2062,54,1575,1094,487
1765555,20,16,1993,12,male,745,973,554,1254,742,460,171,794,571
1062366,19,28,1994,9,female,480,854,761,1247,268,700,133,547,135
1902872,15,25,1998,8,female,434,903,623,1229,1018,687,567,542,451
1509949,21,18,1992,5,female,766,953,221,1173,1106,433,244,740,862
1791543,18,14,1995,5,female,1063,870,375,1257,2380,562,1522,695,858
1681425,16,28,1997,10,female,695,940,461,1274,1107,1123,972,151,135
1800873,18,11,1995,3,male,445,896,745,1146,1029,860,544,286,485
2099561,21,1,1992,10,male,529,849,645,1189,835,867,653,322,182
1226039,24,19,1989,6,female,1360,854,417,1271,1520,1038,1004,233,516
1153196,19,8,1994,2,female,274,840,589,1229,3941,1226,2773,3,1168
1173534,14,13,1999,9,male,214,926,695,1155,544,1155,471,0,73
1899722,19,22,1994,2,male,516,888,633,1281,343,1281,281,0,62
1065456,14,27,1999,2,female,420,850,413,1201,944,1201,796,0,148
2031675,26,3,1987,3,female,330,971,536,1137,1599,1137,998,0,601
1206311,18,2,1995,4,female,626,877,644,1382,695,130,363,1252,332
2188601,16,20,1997,7,female,423,928,631,1342,1261,157,376,1185,885
1119474,16,2,1997,9,female,307,851,639,1504,1183,8,84,1496,1099
1836352,19,18,1994,10,female,1032,932,492,1346,1849,171,572,1175,1277
1735886,19,21,1994,11,female,574,921,611,1487,2699,274,1520,1213,1179
1721326,17,24,1996,1,female,482,915,586,1322,830,479,121,843,709
2026351,31,7,1982,6,female,1197,930,307,1452,996,564,785,888,211
1828611,15,18,1998,11,female,237,914,510,1438,2274,891,1445,547,829
1683023,25,14,1988,10,female,1269,918,354,1384,6696,663,4105,721,2591
1504638,26,17,1987,9,female,1076,921,322,1289,2019,847,1824,442,195
1984739,17,8,1996,8,female,635,914,653,1295,606,1035,420,260,186
2011647,25,5,1988,8,female,1909,904,376,1511,900,1450,719,61,181
1585346,13,28,2000,1,female,169,861,498,1377,1852,1361,1693,16,159
1278395,15,24,1998,11,female,67,894,622,1421,1622,1344,1014,77,608
1274204,14,5,1999,1,female,81,883,389,1372,1490,1167,941,205,549
1605457,15,28,1998,9,female,887,985,610,1459,2178,1159,1062,300,1116
1407294,17,13,1996,1,female,32,952,289,1340,5018,1186,3929,154,1089
1142302,30,21,1983,11,male,403,874,691,1482,115,1482,98,0,17
2148905,24,16,1989,5,female,491,892,189,1472,479,1472,301,0,178
2006001,19,10,1994,11,male,380,955,822,1329,1459,1329,1380,0,79
1750066,23,1,1990,1,female,599,935,292,1389,860,1389,644,0,216
1387585,19,12,1994,1,female,424,925,767,1844,242,159,136,1685,106
1656687,23,2,1990,3,male,623,990,573,1606,908,204,429,1402,479
1716617,14,16,1999,2,male,261,872,710,1718,3870,84,2278,1634,1592
1769021,16,13,1997,12,male,380,902,814,1574,674,841,447,733,227
2152035,19,6,1994,6,female,151,855,669,1529,680,1054,595,475,85
1151745,18,18,1995,10,female,457,878,435,1856,1157,1313,508,543,649
1975459,17,4,1996,4,female,331,964,625,1596,2534,642,1440,954,1094
1710374,16,3,1997,12,female,396,951,674,1767,1069,1736,886,31,183
1850771,18,10,1995,4,male,205,871,541,1605,422,1312,271,293,151
1712217,23,9,1990,9,male,464,838,570,1554,730,1528,638,26,92
1606214,17,29,1996,2,male,1141,869,639,1660,1425,1498,894,162,531
1910640,23,14,1990,11,female,593,977,758,1597,3363,1393,2713,204,650
2082228,23,22,1990,4,female,295,857,431,1562,1033,1559,427,3,606
1028269,15,9,1998,4,male,274,985,801,1823,640,1823,623,0,17
1892420,19,29,1994,5,female,512,994,488,1858,337,1858,258,0,79
1441764,16,20,1997,2,female,511,852,562,1584,1922,1584,1637,0,285
1148676,26,30,1987,5,female,295,905,404,1624,3174,1624,2630,0,544
1499506,28,30,1985,7,female,379,891,454,1899,321,246,172,1653,149
1232604,31,9,1982,10,female,1884,994,542,2120,2373,391,1825,1729,548
1377295,13,2,2000,5,female,494,994,734,2237,5055,68,2400,2169,2655
1194245,15,28,1998,2,female,610,846,361,1957,856,1140,545,817,311
1787854,15,13,1998,8,female,379,938,205,1979,1175,919,559,1060,616
1172761,14,22,1999,11,female,585,846,629,2041,2208,1337,1570,704,638
1026737,14,10,1999,12,female,279,955,371,1931,1255,813,541,1118,714
1930086,14,16,1999,1,female,281,955,396,2065,2493,541,699,1524,1794
1259677,16,19,1997,10,male,207,945,619,2195,2249,1143,1003,1052,1246
1743034,17,22,1996,4,male,89,949,609,1942,1727,1034,1335,908,392
1221584,18,22,1995,3,female,433,922,533,2035,2950,1467,1705,568,1245
1182199,19,11,1994,3,male,109,938,778,2094,2379,1156,1179,938,1200
1335059,19,11,1994,10,female,78,843,164,1920,2329,938,1852,982,477
1231302,23,7,1990,10,female,927,889,437,2009,1839,1409,1433,600,406
1592556,24,16,1989,10,female,375,923,516,1903,2053,1290,876,613,1177
1491057,19,24,1994,8,female,380,845,473,1892,4056,1285,1535,607,2521
1753675,16,29,1997,11,male,555,983,340,1965,782,1900,643,65,139
1336780,20,1,1993,1,male,271,984,822,2186,1196,2028,1094,158,102
1033792,21,10,1992,3,female,599,900,549,1907,951,1707,547,200,404
1077098,26,16,1987,5,male,348,890,784,2331,1072,2274,645,57,427
2048718,20,21,1993,10,female,205,965,221,2158,1793,2011,1371,147,422
1310366,16,22,1997,9,female,43,850,479,2215,7040,1961,4295,254,2745
1862774,20,1,1993,8,female,150,955,130,1979,3498,1874,1913,105,1585
1880512,22,29,1991,1,female,944,954,441,2028,2823,2008,2133,20,690
1620277,15,8,1998,5,male,263,840,690,1972,320,1972,145,0,175
1704800,17,5,1996,7,female,415,923,102,2138,312,2138,243,0,69
1333148,17,14,1996,2,male,473,888,783,1921,346,1921,261,0,85
1786999,20,12,1993,9,male,405,982,713,2124,1506,2124,905,0,601
1464410,24,1,1989,12,female,472,842,158,2156,1941,2156,1602,0,339
1392388,20,23,1993,9,female,322,896,672,1979,5573,1979,5369,0,204
1268781,17,16,1996,3,female,796,936,293,2887,937,29,254,2858,683
1760642,18,11,1995,6,female,32,890,557,3051,1714,250,802,2801,912
1793807,22,12,1991,6,female,378,954,314,2527,1949,123,1042,2404,907
1531922,18,6,1995,3,female,219,867,530,2578,1415,1467,911,1111,504
1207948,20,3,1993,3,female,319,868,619,2961,598,2129,333,832,265
1488469,42,20,1971,11,female,641,967,383,2644,928,1076,337,1568,591
1793964,14,18,1999,5,female,815,958,327,3168,4146,2024,3678,1144,468
1567231,19,26,1994,7,female,363,877,444,3198,1962,1927,918,1271,1044
2066050,26,2,1987,4,male,640,888,577,2402,1472,699,497,1703,975
1302319,28,15,1985,11,female,942,850,323,2745,1870,1452,526,1293,1344
1655748,41,12,1972,11,female,1610,930,471,2796,2069,1854,1106,942,963
1433932,21,30,1992,10,female,711,913,118,2962,4623,1366,2459,1596,2164
1723827,18,15,1995,5,male,1246,866,647,2855,668,2640,459,215,209
1858404,18,20,1995,9,male,242,842,594,2954,1383,2304,512,650,871
1549890,21,5,1992,5,female,190,975,141,3357,3744,2503,2485,854,1259
1061641,40,21,1973,1,female,715,909,386,2382,3203,1949,1529,433,1674
1328744,16,14,1997,3,female,255,888,424,2522,4308,2108,2489,414,1819
1343471,18,4,1995,9,female,260,922,548,2932,5300,2504,4182,428,1118
1453972,25,8,1988,12,female,1544,886,495,3387,5380,3051,3544,336,1836
1178301,16,27,1997,5,male,441,962,854,2408,395,2408,300,0,95
1405193,27,17,1986,8,male,735,872,779,3044,117,3044,108,0,9
1605384,18,29,1995,8,female,319,839,245,2504,1352,2504,1169,0,183
1121810,21,25,1992,5,female,289,961,657,2898,1136,2898,1056,0,80
1174089,28,28,1985,6,female,421,980,411,3204,914,3204,645,0,269
2153948,30,28,1983,2,female,436,878,372,2468,4084,2468,3458,0,626
1045753,17,26,1996,6,male,297,984,655,6033,749,0,43,6033,706
1122131,14,10,1999,4,male,337,978,263,3839,4583,420,1790,3419,2793
1492196,18,2,1995,10,female,494,934,361,4757,5310,596,1468,4161,3842
1801148,20,21,1993,5,female,761,909,110,6170,5862,1007,4783,5163,1079
2000518,26,16,1987,11,female,747,854,386,9013,7927,1728,4254,7285,3673
1178137,18,24,1995,1,female,441,968,590,4521,3011,1100,947,3421,2064
2060817,18,9,1995,6,female,698,846,473,7382,4897,2998,3666,4384,1231
1237688,20,16,1993,12,female,337,853,353,4372,2868,1901,1849,2471,1019
2083921,23,1,1990,9,male,736,867,684,7151,5574,2452,1058,4699,4516
1359467,19,11,1994,6,female,173,869,385,3888,9403,1682,4597,2206,4806
1587929,15,14,1998,8,male,344,977,731,3651,2053,3510,1936,141,117
1710783,20,2,1993,11,male,1389,936,578,3718,957,2729,684,989,273
1140783,23,19,1990,9,female,112,840,769,4105,1741,3259,912,846,829
1535233,25,31,1988,10,male,407,929,739,4654,1862,3887,1381,767,481
1486893,31,2,1982,4,male,361,887,713,6895,4189,6575,2353,320,1836
1123124,17,17,1996,11,male,553,970,620,9116,11226,8546,8274,570,2952
2064896,16,7,1997,9,female,95,856,612,12848,9615,11921,7798,927,1817
1545563,17,4,1996,9,male,44,921,664,4415,2953,4303,2305,112,648
1178386,19,20,1994,8,female,359,941,434,4840,3301,4056,2019,784,1282
1086468,22,4,1991,8,male,458,880,314,10850,9087,10454,4399,396,4688
1730595,23,26,1990,8,female,80,914,607,4068,2834,3788,2294,280,540
1326675,16,29,1997,11,male,623,871,578,5490,2468,5487,1853,3,615
2157909,18,4,1995,8,male,448,900,868,3991,1307,3990,753,1,554
1751505,20,31,1993,3,male,501,983,640,6112,1616,6112,1308,0,308
1397067,26,5,1987,9,male,427,942,586,5443,1100,5443,1008,0,92
2155467,28,10,1985,10,female,248,836,411,5445,1910,5445,1335,0,575
1218924,34,4,1979,5,female,349,911,38,3722,1091,3722,947,0,144
1494855,22,9,1991,7,female,420,934,827,6977,7296,6977,4806,0,2490
1035448,30,15,1983,6,female,275,908,242,4480,6363,4480,5727,0,636
1116097,22,13,1991,5,male,455,1041,624,104,73,59,34,45,39
1759993,25,12,1988,1,male,427,1135,1072,101,224,101,170,0,54
1968209,15,1,1998,11,male,643,1034,874,106,75,2,7,104,68
1132626,19,23,1994,11,male,1360,1158,1036,108,67,33,7,75,60
1463917,15,23,1998,3,female,361,1114,151,107,80,100,24,7,56
1796778,20,16,1993,7,female,1319,1118,485,107,256,88,194,19,62
2190678,24,12,1989,3,female,281,1062,277,108,120,108,113,0,7
1704701,18,30,1995,1,male,642,1126,444,113,143,0,33,113,110
1744210,41,29,1972,8,male,509,1083,934,113,62,112,51,1,11
1456425,27,6,1986,6,male,399,1101,881,112,84,112,59,0,25
1680478,17,19,1996,7,male,274,1037,898,112,200,112,120,0,80
1321359,25,4,1988,7,male,1337,1122,620,112,309,112,276,0,33
1355404,18,31,1995,7,male,1022,1001,863,117,289,112,194,5,95
1872024,19,1,1994,6,female,516,1018,491,122,279,0,154,122,125
1361995,14,13,1999,5,female,273,1070,86,120,159,83,105,37,54
1302746,15,10,1998,1,male,970,1216,797,124,610,74,268,50,342
1604787,26,13,1987,4,female,472,1157,535,124,47,124,40,0,7
1243677,16,19,1997,4,male,1221,1207,758,123,129,123,63,0,66
1966844,15,2,1998,8,female,503,1110,658,123,563,123,428,0,135
1806670,17,4,1996,4,female,597,1264,241,121,319,121,243,0,76
1860560,16,20,1997,3,female,583,1021,683,127,109,2,10,125,99
1017110,17,29,1996,10,male,397,1100,935,128,118,5,51,123,67
1129287,14,22,1999,2,female,522,1035,668,130,177,73,98,57,79
1278156,16,6,1997,9,female,610,1056,663,129,518,86,189,43,329
2061318,19,16,1994,10,female,535,1197,734,127,346,87,223,40,123
1018557,20,21,1993,7,female,1308,1055,163,130,833,60,312,70,521
1540624,20,13,1993,10,male,826,1119,825,128,237,127,155,1,82
1256890,18,8,1995,2,male,347,1048,909,129,133,129,93,0,40
2170832,17,6,1996,11,female,721,1136,430,135,110,45,49,90,61
1942278,16,17,1997,12,female,171,1048,440,134,100,102,39,32,61
1021423,18,15,1995,5,male,506,1003,655,134,195,134,131,0,64
1147187,18,28,1995,12,female,693,1067,596,132,340,132,272,0,68
1391818,16,7,1997,8,female,335,1021,589,140,503,2,383,138,120
1398084,19,12,1994,5,female,618,1009,325,143,347,91,137,52,210
2155100,22,24,1991,11,female,1601,1126,331,143,281,117,126,26,155
1787186,14,10,1999,5,female,321,1019,811,148,156,24,54,124,102
2036528,19,7,1994,1,female,766,1094,535,145,757,145,533,0,224
2077840,16,13,1997,11,female,279,1057,832,151,108,11,64,140,44
1907053,19,8,1994,2,female,1412,997,68,155,188,104,104,51,84
1984645,18,22,1995,12,female,54,1127,122,151,405,62,193,89,212
1766676,18,15,1995,4,male,403,1038,586,152,439,72,109,80,330
2167809,18,21,1995,7,male,1033,1038,716,152,851,101,629,51,222
1960221,15,13,1998,1,female,668,1211,648,155,44,155,39,0,5
2140270,18,21,1995,1,female,531,1075,506,156,289,156,259,0,30
1257650,18,26,1995,9,female,1323,1178,524,161,182,72,137,89,45
1203660,17,7,1996,10,female,609,1208,466,162,347,69,200,93,147
2155614,15,14,1998,2,male,179,1197,1116,158,137,148,125,10,12
1929096,21,13,1992,11,female,325,1198,789,159,211,123,57,36,154
1597113,17,20,1996,8,female,664,1025,494,161,1046,132,467,29,579
1806913,19,12,1994,10,male,526,1089,677,161,333,150,140,11,193
1626132,20,27,1993,12,male,534,1089,936,164,304,164,228,0,76
1396502,18,12,1995,5,male,797,1081,715,167,71,0,30,167,41
1853518,15,10,1998,1,female,708,1040,528,167,195,167,123,0,72
2138977,19,5,1994,8,male,197,1010,683,168,1377,168,810,0,567
1665955,15,8,1998,10,female,89,996,385,181,984,93,425,88,559
1281414,15,29,1998,3,female,563,1150,556,173,154,166,64,7,90
1918731,16,5,1997,9,female,630,1243,644,179,483,161,440,18,43
1235096,19,5,1994,5,male,453,1173,746,176,118,176,88,0,30
1893801,18,2,1995,8,male,389,1092,868,181,461,181,366,0,95
1124679,28,8,1985,10,male,728,1150,919,177,277,177,182,0,95
1990099,19,24,1994,6,female,813,1181,815,185,486,98,230,87,256
1871287,21,21,1992,8,female,743,1041,346,186,1224,99,588,87,636
1785185,24,5,1989,4,male,664,1059,920,189,12,138,11,51,1
2126797,18,9,1995,5,female,463,1093,303,186,229,186,108,0,121
1264796,20,1,1993,12,male,268,1155,392,183,247,183,190,0,57
1809022,41,31,1972,12,male,439,1137,897,187,202,187,182,0,20
1205947,19,23,1994,12,female,524,1044,189,183,458,183,349,0,109
1175438,21,9,1992,6,female,559,1100,588,182,314,182,251,0,63
1604790,23,29,1990,11,female,674,1251,449,187,877,187,636,0,241
1876164,19,11,1994,3,female,303,1073,481,198,460,115,307,83,153
1923389,18,25,1995,6,female,467,1184,750,200,356,176,145,24,211
1102886,22,9,1991,4,female,1253,1191,435,200,413,193,287,7,126
1215639,22,26,1991,10,female,479,1095,78,200,92,200,75,0,17
2131613,15,28,1998,12,female,506,1054,778,193,286,193,227,0,59
1492015,16,9,1997,10,male,620,1037,449,193,208,193,182,0,26
1730988,23,9,1990,9,male,762,1070,503,196,271,196,249,0,22
1233153,20,19,1993,3,female,284,1264,485,191,1554,191,1258,0,296
2172609,23,10,1990,5,male,672,1263,1132,210,100,50,71,160,29
1282048,14,17,1999,5,female,171,1020,330,208,703,143,467,65,236
1922302,22,19,1991,11,female,1458,1120,515,208,1093,127,656,81,437
1887449,18,17,1995,10,male,1556,1052,555,206,142,189,123,17,19
1244088,14,21,1999,8,female,461,1018,172,207,597,207,332,0,265
1239294,17,10,1996,5,female,665,1184,809,207,796,207,679,0,117
1048671,16,16,1997,4,male,648,1173,823,220,153,52,99,168,54
1642117,16,20,1997,6,female,528,1137,609,214,640,120,430,94,210
1155441,16,24,1997,7,female,482,1055,580,217,521,132,234,85,287
2068888,15,16,1998,11,female,678,1024,611,217,461,197,262,20,199
1679536,16,13,1997,11,male,676,1038,783,217,570,169,358,48,212
2149786,19,1,1994,4,female,601,1156,209,213,1388,200,884,13,504
2118930,22,10,1991,1,male,281,1069,997,217,46,217,38,0,8
1172881,15,23,1998,10,female,314,1016,98,217,512,217,372,0,140
1578318,15,16,1998,10,female,613,1118,308,228,349,51,164,177,185
1231360,17,28,1996,5,female,540,1132,708,231,414,139,303,92,111
1064683,20,20,1993,12,female,814,1191,807,231,358,49,88,182,270
1383825,20,27,1993,10,male,480,1105,929,230,127,184,91,46,36
1360458,21,17,1992,8,male,571,1010,719,222,250,195,141,27,109
1385913,23,25,1990,9,female,808,1020,667,226,543,203,388,23,155
1774557,18,23,1995,4,male,1166,1198,829,229,58,229,47,0,11
2115375,13,7,2000,3,female,65,1045,244,224,201,224,140,0,61
1759451,18,23,1995,3,female,287,1190,155,243,204,4,158,239,46
2124448,14,25,1999,1,female,793,1224,409,235,380,28,179,207,201
2056111,21,5,1992,3,female,1860,1000,484,242,458,43,242,199,216
1482584,16,20,1997,11,female,521,1162,629,241,86,103,45,138,41
2078060,16,29,1997,9,female,1017,1107,347,243,596,83,177,160,419
1989519,15,18,1998,10,female,313,1110,390,243,1338,237,1225,6,113
2030219,26,6,1987,2,female,1201,1071,547,246,141,246,69,0,72
1387317,25,8,1988,7,female,36,1239,37,243,815,243,716,0,99
1069024,19,5,1994,10,female,545,1236,508,256,478,22,302,234,176
1996158,27,2,1986,2,male,429,1229,946,254,572,0,104,254,468
1428950,27,14,1986,12,male,573,1043,470,260,699,131,239,129,460
1246197,17,27,1996,8,female,538,1139,880,254,179,245,169,9,10
2008828,19,4,1994,1,female,841,1250,418,249,3866,186,2970,63,896
1972884,20,29,1993,10,female,56,1041,26,259,1163,236,616,23,547
1114933,20,29,1993,12,female,676,1224,703,258,137,256,108,2,29
1111598,18,1,1995,1,male,557,1237,1105,255,140,255,133,0,7
1093263,24,25,1989,7,female,602,998,574,276,200,0,115,276,85
1073783,18,11,1995,8,female,555,1079,459,276,166,199,58,77,108
1507387,20,24,1993,11,male,830,1209,988,263,297,74,220,189,77
1453456,19,26,1994,4,female,424,1112,776,269,442,109,188,160,254
1962958,23,23,1990,8,male,1382,1231,1005,276,4,276,3,0,1
1554697,16,3,1997,8,male,535,1265,383,269,411,269,268,0,143
2151461,19,11,1994,8,male,520,1219,926,271,768,271,598,0,170
2023304,17,2,1996,3,female,539,1234,158,287,199,22,60,265,139
1047021,16,12,1997,5,female,302,1033,436,281,430,29,158,252,272
1597386,18,22,1995,8,female,624,1095,556,283,333,157,227,126,106
1407257,22,20,1991,12,female,950,1030,343,280,232,220,151,60,81
1973483,17,28,1996,9,female,324,1182,509,287,714,284,230,3,484
1400352,24,13,1989,8,female,1604,1063,413,277,416,243,376,34,40
1788746,22,15,1991,1,male,443,1142,1056,278,64,278,63,0,1
2138345,15,12,1998,11,male,511,1036,901,289,406,289,335,0,71
1039591,16,18,1997,3,female,396,1165,903,282,224,282,174,0,50
1960766,24,2,1989,3,female,402,1184,721,289,369,289,256,0,113
1333713,17,5,1996,8,female,360,1220,207,290,1709,290,874,0,835
1419732,19,28,1994,2,female,521,1195,664,281,475,281,305,0,170
1161048,19,14,1994,12,female,80,1102,483,305,1005,298,505,7,500
1317069,18,25,1995,10,female,85,1023,272,295,127,293,55,2,72
1191604,16,5,1997,5,male,375,1076,913,325,11,0,8,325,3
1639821,19,5,1994,12,female,576,1073,465,309,432,41,230,268,202
2125022,19,29,1994,7,male,772,1080,710,310,77,222,57,88,20
1150106,19,19,1994,8,female,840,1086,657,313,394,82,290,231,104
1369346,19,8,1994,10,female,1530,1097,401,312,742,130,272,182,470
1590129,16,18,1997,2,female,484,1234,781,312,452,297,379,15,73
1408155,21,15,1992,5,female,635,1174,462,323,1165,318,476,5,689
1608799,21,13,1992,6,female,796,1081,715,323,497,314,342,9,155
2181637,42,10,1971,6,female,1746,1144,535,312,1424,270,1103,42,321
1051638,15,11,1998,11,male,409,1231,980,318,3265,318,2567,0,698
1879520,26,6,1987,5,female,1637,1150,454,313,679,313,519,0,160
1462430,40,9,1973,10,female,717,1034,85,310,1111,310,605,0,506
1230661,18,10,1995,9,female,565,1042,466,337,129,12,63,325,66
1087201,18,14,1995,9,female,361,1060,550,339,883,11,385,328,498
1057889,14,10,1999,1,male,326,1255,1127,335,103,212,66,123,37
1161957,24,17,1989,4,male,448,1063,930,338,409,195,375,143,34
1755231,24,11,1989,10,female,432,1042,447,339,214,242,125,97,89
2082520,19,7,1994,3,female,1496,1023,643,340,626,100,466,240,160
1361416,19,28,1994,8,male,1376,1148,606,340,1236,279,958,61,278
1765801,29,1,1984,1,male,717,1186,1054,338,47,338,38,0,9
1646271,20,19,1993,10,male,638,1116,554,343,208,343,194,0,14
1976709,19,6,1994,3,female,744,1197,371,333,440,333,279,0,161
1039573,36,11,1977,12,female,1732,1054,433,363,191,130,111,233,80
1956776,21,5,1992,1,female,1570,1149,503,364,487,156,384,208,103
1077097,26,30,1987,8,male,1112,1080,726,357,372,73,212,284,160
1711714,13,1,2000,1,female,390,1067,171,359,211,278,148,81,63
1071393,17,4,1996,5,female,894,1204,672,353,197,295,173,58,24
1594163,17,29,1996,4,female,715,1252,807,356,286,276,93,80,193
1351079,17,6,1996,7,female,1371,1202,250,359,1742,359,1143,0,599
1179391,13,4,2000,6,female,820,1047,624,382,246,105,108,277,138
2054826,19,9,1994,9,male,1169,1019,492,385,599,218,302,167,297
1063351,20,10,1993,11,female,1734,1074,413,377,408,282,196,95,212
1644369,14,10,1999,6,female,118,1036,483,392,1166,376,939,16,227
1675207,19,17,1994,5,male,587,1058,563,377,581,364,500,13,81
1146847,19,16,1994,8,female,15,1038,264,380,671,366,481,14,190
1764984,25,21,1988,2,female,441,1002,830,379,241,376,214,3,27
2117458,33,14,1980,10,male,1758,1054,703,381,231,381,160,0,71
1939102,20,30,1993,10,female,606,1016,463,385,312,385,298,0,14
1757753,21,4,1992,4,male,529,1135,837,375,362,375,251,0,111
1941412,17,16,1996,9,female,1255,1253,299,407,863,27,668,380,195
1053638,32,4,1981,4,female,1571,1100,223,406,1073,59,523,347,550
1842536,17,27,1996,3,male,849,1139,636,401,381,266,280,135,101
2142682,18,29,1995,5,male,1378,1253,449,400,419,107,320,293,99
1268085,23,16,1990,1,male,1790,1172,530,410,488,84,272,326,216
1194656,19,4,1994,8,female,869,1132,486,409,1719,289,1215,120,504
1707025,21,25,1992,8,female,684,1018,252,400,949,189,164,211,785
1313101,23,24,1990,12,female,266,1256,495,402,1083,192,407,210,676
1245707,23,28,1990,3,female,176,1078,36,396,1165,333,942,63,223
1928123,24,29,1989,9,female,1246,1009,547,409,1019,315,539,94,480
1976093,21,13,1992,12,male,227,1172,1023,415,320,415,304,0,16
1533161,23,24,1990,5,female,338,1124,363,399,360,399,318,0,42
1668129,15,29,1998,4,male,212,1072,868,429,466,65,166,364,300
1914350,22,22,1991,7,female,444,1031,358,431,579,82,298,349,281
1909640,15,17,1998,3,female,201,1011,320,435,2630,22,1186,413,1444
1020006,16,20,1997,11,female,545,998,234,445,612,194,390,251,222
1590203,15,8,1998,5,male,476,1232,735,436,1815,178,1064,258,751
1840900,19,20,1994,7,female,551,1138,179,443,1019,193,252,250,767
1000008,14,9,1999,9,female,343,1156,233,431,198,400,167,31,31
2144861,15,18,1998,2,male,902,1143,803,446,122,365,112,81,10
2006363,19,14,1994,8,male,202,999,905,430,236,351,130,79,106
1710476,18,8,1995,5,female,417,1205,859,434,284,336,227,98,57
1309483,20,3,1993,3,female,544,1233,246,445,601,352,303,93,298
2182886,28,15,1985,4,male,958,1168,935,441,414,434,341,7,73
2053206,17,7,1996,11,female,538,1011,683,442,1554,416,927,26,627
1761653,16,4,1997,8,female,1261,1167,250,440,840,387,340,53,500
1320716,20,1,1993,3,female,838,1007,550,448,675,440,580,8,95
1836399,15,23,1998,6,female,480,1059,682,437,618,435,442,2,176
1059722,24,5,1989,7,female,729,1139,762,440,265,440,230,0,35
2064745,16,1,1997,1,female,732,1119,518,448,317,448,272,0,45
1562152,27,7,1986,8,male,597,1111,562,439,472,439,291,0,181
1794399,17,2,1996,12,male,744,1163,500,437,1314,437,726,0,588
1282747,15,26,1998,8,male,588,1012,521,471,609,82,406,389,203
1443970,20,9,1993,3,male,700,1018,502,462,295,44,81,418,214
1442607,14,5,1999,2,female,796,1177,156,480,968,53,779,427,189
1659642,17,24,1996,7,male,552,1029,832,462,573,236,361,226,212
1655155,21,30,1992,3,female,842,1212,538,470,690,246,434,224,256
1611090,25,2,1988,4,female,381,1021,467,471,507,181,299,290,208
1737000,38,23,1975,12,male,910,1189,492,462,1383,240,403,222,980
2084013,36,18,1977,12,male,1409,1037,243,475,346,376,153,99,193
2007607,17,31,1996,8,female,643,1120,444,470,1030,358,808,112,222
1899032,18,24,1995,2,male,233,1030,715,458,1914,424,1185,34,729
1103068,18,30,1995,8,female,1937,1199,300,454,1386,431,725,23,661
2061805,20,6,1993,9,male,403,1012,813,466,89,466,81,0,8
1836427,22,16,1991,12,female,524,1056,317,466,462,466,420,0,42
1344060,15,29,1998,4,female,490,1162,910,459,1088,459,1068,0,20
1365005,18,5,1995,10,male,625,1155,942,499,394,353,251,146,143
2169926,22,6,1991,12,male,728,1088,507,490,847,116,375,374,472
1730384,21,22,1992,4,male,664,1238,990,495,1466,105,485,390,981
1644026,31,10,1982,8,female,775,1177,1009,507,634,498,557,9,77
1603035,13,11,2000,8,female,101,1008,676,498,1936,391,1188,107,748
1996132,16,13,1997,6,female,621,1001,644,485,872,380,438,105,434
2081278,18,31,1995,8,female,796,1201,184,511,1694,502,1583,9,111
1834109,21,4,1992,3,male,764,1022,755,503,248,503,174,0,74
1419184,18,1,1995,1,female,82,1034,255,493,2545,493,2004,0,541
2134846,23,22,1990,12,male,937,1209,1053,540,605,37,552,503,53
1368542,16,14,1997,5,male,801,1045,350,556,3078,27,1237,529,1841
2058423,16,21,1997,4,female,569,1049,483,561,446,184,309,377,137
1378130,20,29,1993,12,female,694,1018,571,531,539,371,313,160,226
1040445,19,5,1994,12,female,661,1134,295,547,2792,204,1581,343,1211
1330543,18,5,1995,3,female,819,1124,506,526,178,471,94,55,84
1176194,19,24,1994,8,female,1561,1204,672,533,313,459,168,74,145
1919783,41,29,1972,12,male,1043,1098,747,525,767,410,550,115,217
1356377,20,1,1993,10,male,363,1206,579,567,899,48,381,519,518
2017854,14,11,1999,5,female,590,1120,757,600,485,318,284,282,201
1819679,19,15,1994,2,male,578,1159,630,600,667,133,210,467,457
1135116,20,29,1993,6,female,855,1080,716,567,636,186,307,381,329
1002613,25,30,1988,11,female,782,1130,588,598,663,428,182,170,481
1110352,42,1,1971,12,female,1725,1243,1025,586,884,177,695,409,189
1756058,31,13,1982,9,female,398,1113,926,599,681,571,444,28,237
2043317,17,17,1996,7,female,383,1128,750,582,1562,575,1276,7,286
1309167,42,8,1971,6,female,218,1106,514,606,1329,514,597,92,732
1922408,18,18,1995,8,female,262,1220,721,608,1163,602,895,6,268
1077030,25,1,1988,1,male,242,1022,61,563,1245,560,685,3,560
1544982,21,6,1992,9,male,493,1038,709,578,721,578,612,0,109
1404625,16,19,1997,1,male,575,1092,927,618,446,94,241,524,205
1429613,16,1,1997,6,female,247,1211,972,622,404,18,246,604,158
2180253,21,13,1992,9,male,575,1067,747,637,800,44,240,593,560
2122319,22,17,1991,1,female,219,1030,840,617,1136,1,232,616,904
1723795,17,5,1996,12,female,402,1010,139,630,155,429,93,201,62
1663163,15,7,1998,10,female,468,1041,452,620,1114,521,480,99,634
1649485,24,10,1989,4,female,899,1210,534,613,942,559,368,54,574
1690988,15,13,1998,8,male,351,1037,903,616,281,616,249,0,32
2184200,18,26,1995,2,female,242,1191,825,612,281,612,264,0,17
1871838,19,29,1994,12,male,868,1266,1039,613,450,613,372,0,78
2109254,16,17,1997,7,female,585,1075,661,620,935,620,662,0,273
2143647,20,4,1993,8,male,256,1084,503,635,1967,635,1202,0,765
1578402,16,17,1997,9,male,390,1099,701,719,1943,70,654,649,1289
2163569,21,12,1992,7,female,1433,1007,699,691,395,174,183,517,212
2130851,26,7,1987,10,female,1213,1012,674,698,586,201,163,497,423
1459269,18,28,1995,5,female,727,1132,310,668,1380,433,352,235,1028
1271934,20,27,1993,10,female,523,1076,138,675,3267,245,1267,430,2000
1301079,38,30,1975,4,female,755,996,677,717,1238,256,433,461,805
1884941,32,3,1981,6,male,13,1039,902,708,400,618,396,90,4
1032493,14,18,1999,8,male,443,1111,554,698,906,656,366,42,540
1338312,16,1,1997,6,female,463,1060,598,693,921,673,674,20,247
2109384,18,29,1995,7,female,240,1269,616,712,3072,526,2733,186,339
1801601,18,18,1995,12,female,810,1062,655,678,110,678,86,0,24
1487435,19,9,1994,6,male,571,1162,857,691,110,691,88,0,22
1100095,20,23,1993,3,male,645,1134,909,722,62,722,56,0,6
1022695,20,12,1993,12,male,576,1103,905,709,419,709,337,0,82
1300713,32,17,1981,9,male,510,1064,885,689,168,689,158,0,10
1650020,17,2,1996,5,female,510,1251,545,715,981,715,889,0,92
1187719,18,28,1995,3,male,413,1020,783,708,1181,708,983,0,198
1831973,16,11,1997,5,female,1012,1065,255,785,1124,152,342,633,782
2048246,19,10,1994,8,female,763,1115,419,763,1029,119,548,644,481
1587947,17,11,1996,1,female,589,1265,369,734,580,194,298,540,282
2083022,18,22,1995,3,female,459,1265,767,791,4359,270,2826,521,1533
1242403,19,9,1994,7,female,1545,1186,316,775,1530,396,445,379,1085
1759519,19,10,1994,9,female,461,1209,795,750,1730,486,850,264,880
1775592,23,20,1990,12,male,391,1005,792,780,331,660,250,120,81
1620309,15,6,1998,6,female,401,1096,570,759,485,660,374,99,111
2060763,17,25,1996,11,female,625,1081,307,791,1185,699,599,92,586
1543460,16,19,1997,2,female,562,1207,665,791,695,589,661,202,34
1500748,23,19,1990,9,male,848,1100,381,735,807,711,229,24,578
1488236,20,4,1993,5,male,623,1078,854,740,133,740,115,0,18
1911729,40,30,1973,10,female,714,1104,437,794,1168,794,1023,0,145
1953187,20,15,1993,12,female,176,1144,202,785,1312,785,651,0,661
1770547,29,12,1984,11,male,386,1027,848,768,1537,768,1475,0,62
2186392,18,14,1995,4,female,346,1043,549,856,1000,127,595,729,405
1119231,20,17,1993,10,female,255,1187,785,816,974,97,488,719,486
1831369,26,26,1987,6,female,369,1029,712,808,2253,9,840,799,1413
1122422,31,24,1982,7,female,880,1210,264,807,1724,63,622,744,1102
1459750,18,12,1995,1,female,382,1108,102,849,460,561,274,288,186
1634388,18,17,1995,3,female,1476,1222,398,830,454,567,274,263,180
2018875,21,26,1992,12,female,549,1098,368,856,173,499,43,357,130
2104953,26,9,1987,9,female,250,1137,686,862,390,347,312,515,78
1753908,16,9,1997,8,female,497,1087,850,872,564,372,343,500,221
1404779,18,26,1995,1,male,822,1024,843,828,1231,454,746,374,485
1150974,18,28,1995,1,male,437,1206,1067,857,960,232,585,625,375
1118346,20,4,1993,1,male,975,1034,585,845,559,425,250,420,309
1109971,18,1,1995,6,female,205,1229,26,877,1760,184,1123,693,637
1189135,17,12,1996,4,female,1351,1221,550,867,479,732,253,135,226
1618776,17,21,1996,11,female,1659,1115,195,826,1093,674,817,152,276
1145504,18,20,1995,6,female,1394,1121,437,801,963,644,417,157,546
2135555,38,17,1975,2,male,514,1026,190,822,3476,768,1003,54,2473
1001096,14,14,1999,2,female,360,1196,832,851,499,851,432,0,67
1516706,17,18,1996,5,male,660,1119,844,822,456,822,410,0,46
2092683,25,22,1988,12,male,529,1001,444,862,166,862,139,0,27
1148440,18,1,1995,3,female,212,1114,469,835,2654,835,1763,0,891
1202860,16,22,1997,8,male,443,1053,985,955,582,22,347,933,235
1417515,21,4,1992,3,male,501,1192,601,974,1869,114,932,860,937
1041953,19,12,1994,5,female,865,1159,600,881,1282,526,565,355,717
1620338,20,12,1993,2,female,246,1015,710,908,1075,573,577,335,498
1284790,17,26,1996,3,male,615,1201,939,982,664,885,377,97,287
1439106,16,10,1997,11,female,587,1170,766,926,2328,866,1374,60,954
1827101,20,17,1993,12,male,790,1129,616,903,374,903,344,0,30
1219119,26,17,1987,8,male,395,1153,758,890,348,890,317,0,31
2099131,27,14,1986,2,male,446,1150,860,914,832,914,827,0,5
1878083,15,19,1998,8,male,312,1117,841,1039,439,117,168,922,271
1663926,15,16,1998,9,female,801,1232,658,1010,2331,52,1233,958,1098
1293077,20,3,1993,7,female,1457,1250,400,1061,1958,158,722,903,1236
1910511,18,30,1995,10,female,228,1135,497,1074,480,668,293,406,187
1678114,16,16,1997,1,male,465,999,658,1102,1087,699,471,403,616
1272055,17,29,1996,10,male,145,1185,1032,993,706,215,117,778,589
1273093,20,11,1993,5,female,466,1072,603,1049,706,277,189,772,517
2008986,33,1,1980,6,male,415,1053,573,1066,1542,285,317,781,1225
2041477,16,24,1997,8,female,334,1177,783,1094,3888,520,1370,574,2518
1365651,17,11,1996,5,female,133,1254,932,1053,2248,605,772,448,1476
2185372,18,7,1995,8,male,110,1256,702,1005,2092,556,1139,449,953
1703069,19,29,1994,10,female,148,1116,672,1054,4509,213,1363,841,3146
2011346,20,28,1993,12,male,734,1037,292,1120,640,856,389,264,251
1486021,20,11,1993,6,female,786,1009,647,1031,305,764,169,267,136
1502651,18,16,1995,10,female,585,1077,343,989,668,953,473,36,195
1814778,23,30,1990,7,male,491,1241,681,1104,2437,892,1504,212,933
1780363,16,1,1997,8,female,541,1048,661,1105,742,1103,300,2,442
1145091,15,12,1998,12,male,544,1101,774,1098,294,1098,245,0,49
1620453,15,1,1998,12,female,559,1226,860,1049,623,1049,557,0,66
1615922,26,16,1987,3,female,240,1038,777,988,507,988,239,0,268
1362862,18,25,1995,9,female,174,1051,629,1108,699,1108,620,0,79
1280589,19,23,1994,7,male,407,1047,583,992,1248,992,1070,0,178
1918429,20,3,1993,3,female,732,1204,802,1192,773,26,369,1166,404
1451179,15,25,1998,10,female,383,1025,429,1153,1780,128,803,1025,977
1077741,16,7,1997,8,female,872,1054,656,1150,589,237,357,913,232
1005458,14,18,1999,3,female,478,1025,532,1165,793,403,313,762,480
1940928,16,18,1997,9,female,1006,1123,300,1213,1599,760,924,453,675
1201943,18,13,1995,11,female,169,998,657,1258,1274,737,868,521,406
1544554,20,25,1993,7,female,1518,1022,422,1140,895,375,343,765,552
1113782,23,1,1990,1,female,1618,1052,578,1141,869,314,502,827,367
1639620,25,11,1988,9,female,187,1065,978,1218,1296,686,634,532,662
1549109,26,28,1987,3,male,299,1113,375,1197,2024,635,1023,562,1001
1423936,38,5,1975,1,female,1747,1144,596,1132,2540,755,1080,377,1460
1107983,20,4,1993,12,female,210,1161,892,1211,301,1147,218,64,83
1719307,19,21,1994,9,female,277,1085,951,1268,672,1232,303,36,369
1279127,37,7,1976,3,female,479,1091,947,1156,443,953,344,203,99
2191024,14,1,1999,6,male,169,1231,1101,1138,1331,996,1142,142,189
1680597,15,17,1998,9,female,449,1233,683,1275,1226,1230,1036,45,190
2011940,18,7,1995,7,male,653,1218,649,1257,1436,1031,836,226,600
1114082,21,16,1992,6,male,1436,1040,631,1250,928,1230,701,20,227
2177118,17,8,1996,6,female,281,1224,183,1279,2432,1035,926,244,1506
1333320,19,12,1994,10,female,1134,1129,473,1233,2160,1015,1259,218,901
1975125,29,28,1984,8,female,769,1036,648,1176,1945,994,1302,182,643
1866281,33,9,1980,5,female,905,1027,375,1231,2490,1202,1361,29,1129
1991613,18,15,1995,12,female,361,1092,304,1208,1459,1204,715,4,744
1055112,21,26,1992,12,female,716,1268,562,1252,784,1249,545,3,239
1218066,14,27,1999,4,male,356,1047,917,1271,3154,1267,2743,4,411
1995267,16,6,1997,12,male,558,1094,839,1138,263,1138,225,0,38
1704599,17,11,1996,11,female,542,1257,870,1211,1355,1211,1207,0,148
1887870,16,25,1997,2,female,551,1023,669,1225,1297,1225,1106,0,191
1117388,26,1,1987,1,female,304,1072,605,1179,5879,1179,5092,0,787
1885427,28,6,1985,6,female,372,1050,169,1161,2134,1161,1967,0,167
1206939,18,28,1995,1,female,337,1065,699,1402,459,25,74,1377,385
1538209,15,7,1998,5,female,555,1010,400,1429,901,12,369,1417,532
1905569,16,2,1997,5,female,601,1238,463,1300,1809,24,736,1276,1073
1906546,21,21,1992,9,female,741,1049,568,1493,1190,27,710,1466,480
1759140,21,30,1992,12,female,315,1121,900,1499,273,739,161,760,112
1855916,26,27,1987,12,male,669,1054,931,1335,676,625,493,710,183
1428159,17,26,1996,4,male,716,1219,643,1368,1042,985,720,383,322
1398833,17,24,1996,6,female,508,1053,587,1484,1338,845,865,639,473
1743569,17,30,1996,8,male,778,1081,827,1350,1956,291,1326,1059,630
1294823,18,15,1995,1,female,1470,1058,383,1399,1519,539,1212,860,307
1471163,19,3,1994,6,female,690,1199,226,1413,3505,577,1396,836,2109
1670596,21,28,1992,9,female,438,1098,322,1367,5383,642,2792,725,2591
1287842,17,18,1996,4,female,916,1094,604,1358,967,1023,362,335,605
1349858,20,15,1993,9,female,440,1132,853,1319,1794,955,1062,364,732
2101538,23,20,1990,5,female,158,1074,561,1347,840,1194,491,153,349
1598252,29,11,1984,1,female,2112,1226,530,1431,969,1392,320,39,649
2157773,19,2,1994,2,female,423,1115,467,1434,4191,1404,2715,30,1476
1552177,19,15,1994,6,male,174,1013,380,1310,7657,1286,5006,24,2651
1911928,15,12,1998,7,female,415,1095,629,1508,255,1503,164,5,91
2112148,38,4,1975,5,female,489,1158,334,1389,1431,1383,1203,6,228
2187936,21,15,1992,10,female,408,1160,781,1407,3029,1400,1939,7,1090
1647513,36,28,1977,6,male,563,1144,422,1322,359,1322,344,0,15
1508348,17,8,1996,5,female,875,1267,343,1488,3975,1488,3049,0,926
1751676,16,3,1997,9,female,443,1225,778,1804,2083,33,528,1771,1555
1952407,17,27,1996,2,female,1000,1085,655,1600,1937,31,886,1569,1051
1206543,23,25,1990,4,female,73,1193,877,1660,1679,201,207,1459,1472
1211415,21,20,1992,11,male,258,1240,892,1659,650,381,394,1278,256
1329711,15,2,1998,6,female,556,1179,1001,1760,1215,962,429,798,786
1239931,15,4,1998,9,female,1151,1080,406,1775,1659,931,657,844,1002
1771542,16,24,1997,6,female,252,1006,487,1549,1097,1030,835,519,262
1694445,17,3,1996,7,female,563,1031,873,1721,1070,766,442,955,628
1705411,18,5,1995,5,female,267,1010,184,1622,1049,1078,367,544,682
1071480,25,16,1988,5,male,876,1003,445,1562,1784,566,402,996,1382
2014609,18,2,1995,5,female,767,1059,229,1754,4434,678,1294,1076,3140
1013194,19,4,1994,5,male,212,998,610,1651,4491,451,2018,1200,2473
1646470,19,10,1994,10,male,84,1123,443,1854,3320,1243,1982,611,1338
1940138,23,30,1990,11,female,656,1078,694,1826,3665,928,2016,898,1649
1993569,15,24,1998,7,female,418,1144,723,1780,547,1750,402,30,145
1297646,19,14,1994,4,male,433,1020,889,1549,667,1292,312,257,355
2041104,16,29,1997,11,female,665,1179,793,1727,1841,1407,1319,320,522
2145460,16,26,1997,5,male,1054,1258,573,1644,2242,1528,938,116,1304
1553906,18,21,1995,5,male,460,1077,570,1784,1814,1651,1308,133,506
1508767,17,20,1996,5,female,563,1193,292,1842,2873,1777,2284,65,589
1979737,19,26,1994,6,female,488,1105,758,1625,613,1622,362,3,251
1265372,21,20,1992,7,female,971,1208,546,1677,963,1677,864,0,99
1308028,29,1,1984,1,male,364,1158,1074,1747,467,1747,396,0,71
2122233,32,29,1981,12,male,497,1108,895,1554,450,1554,398,0,52
2164803,14,29,1999,4,female,441,1186,628,1717,2136,1717,1758,0,378
2039405,16,14,1997,8,female,257,1227,850,1800,1223,1800,1100,0,123
1592354,20,10,1993,11,male,651,1070,676,2138,519,278,227,1860,292
1565262,15,16,1998,4,female,613,1010,500,2070,2471,200,965,1870,1506
2015096,18,2,1995,7,female,182,1014,516,2219,1429,374,265,1845,1164
2061751,21,30,1992,9,male,222,1119,554,1893,3170,285,1153,1608,2017
1333149,18,2,1995,3,female,375,1124,336,1898,426,1089,307,809,119
1011509,23,20,1990,1,female,1046,1062,555,1949,727,608,199,1341,528
1704576,19,7,1994,11,female,732,1141,519,2002,1502,980,334,1022,1168
1814310,19,24,1994,8,male,227,1079,874,2225,2517,588,1215,1637,1302
1174974,16,1,1997,4,female,227,1090,887,2285,1007,2202,915,83,92
1834488,16,27,1997,5,female,612,1199,727,2261,1145,1767,667,494,478
1568282,19,4,1994,3,male,97,1036,919,2290,1348,1869,1211,421,137
1622889,15,20,1998,5,female,1096,1185,335,2004,2436,1830,1842,174,594
1698567,19,17,1994,2,female,600,1028,754,1916,1292,1672,722,244,569
2163614,25,9,1988,9,female,516,1037,442,1911,2002,1775,1271,136,731
1367055,18,11,1995,5,female,442,1203,593,1893,4212,1836,3457,57,755
1298429,20,9,1993,7,female,206,1170,799,2240,754,2239,430,1,324
1609305,29,4,1984,9,male,449,1057,883,1944,218,1944,195,0,23
2036993,19,22,1994,1,female,286,1037,658,2106,1431,2106,1204,0,227
1950623,19,22,1994,2,female,520,1006,478,2339,2199,2339,1703,0,496
1452297,25,8,1988,5,male,1234,1162,958,2327,1440,2327,471,0,969
1982672,27,26,1986,12,female,711,1208,363,1944,3130,1944,2870,0,260
1209271,19,19,1994,11,female,353,1197,574,2401,1355,96,750,2305,605
1240248,13,14,2000,7,female,970,1183,491,3414,3428,109,1360,3305,2068
1363660,17,19,1996,4,female,473,1084,569,3074,4553,252,3515,2822,1038
2040443,26,1,1987,1,female,35,1054,708,2430,2626,136,360,2294,2266
1950511,16,2,1997,3,male,336,1113,858,3416,800,1441,519,1975,281
2065720,15,1,1998,2,male,205,1102,705,3514,2344,1127,1183,2387,1161
1338347,15,25,1998,3,female,177,1147,862,3314,3183,1031,1366,2283,1817
1737656,18,28,1995,9,female,667,1228,970,3370,2807,2038,2033,1332,774
1395813,13,27,2000,6,female,676,1239,500,3368,9919,1710,2993,1658,6926
1020353,15,20,1998,11,female,819,1041,675,2522,1012,2207,699,315,313
1472001,18,6,1995,12,male,747,1261,918,2648,1294,2178,899,470,395
1002882,23,13,1990,3,male,262,1049,874,3532,868,3144,625,388,243
2047332,16,27,1997,11,male,377,1002,590,2856,2012,2692,1767,164,245
1903238,15,11,1998,4,female,276,1122,324,2927,1966,2786,1491,141,475
1615033,18,3,1995,12,female,1007,1143,648,2895,1791,2430,1154,465,637
1335890,22,9,1991,5,female,538,1079,657,3137,2281,2730,1467,407,814
1045917,23,22,1990,4,male,529,1132,664,2752,2388,2116,1468,636,920
1089286,18,20,1995,6,female,654,1033,162,2599,4055,2524,2072,75,1983
1730451,19,7,1994,1,male,311,1062,779,2775,2483,2767,1479,8,1004
1265320,23,10,1990,6,male,483,1041,828,3097,444,3097,374,0,70
1746170,17,31,1996,7,male,675,1225,862,2589,1339,2589,1281,0,58
2072545,17,22,1996,10,female,266,1076,463,2434,933,2434,834,0,99
2156811,19,23,1994,11,male,825,1020,906,2623,1095,2623,758,0,337
1960475,31,31,1982,3,female,467,1037,107,2883,572,2883,514,0,58
1484526,24,19,1989,8,female,959,1072,765,2525,1952,2525,1750,0,202
1559095,23,1,1990,10,female,388,1140,639,6940,3123,65,986,6875,2137
1570692,14,30,1999,10,female,816,1174,749,8326,5792,1561,3778,6765,2014
1353893,19,1,1994,11,male,305,1092,238,10803,7748,901,3919,9902,3829
1748468,20,22,1993,8,female,1486,1182,553,7156,5026,1403,3481,5753,1545
1298937,19,7,1994,5,female,568,1095,494,6980,10690,1298,5713,5682,4977
1800195,18,16,1995,12,female,1003,1108,492,6280,3100,3026,1598,3254,1502
1812645,17,13,1996,6,male,651,1222,591,4059,1487,1404,572,2655,915
1530437,18,5,1995,8,female,1100,1134,616,4583,2737,2626,1550,1957,1187
2103193,15,3,1998,5,male,1042,1266,905,5022,6168,3053,3000,1969,3168
1826481,19,1,1994,12,female,303,1230,387,5490,3879,1960,2380,3530,1499
1005210,18,15,1995,9,female,667,1162,329,10762,11783,6669,6630,4093,5153
1130367,19,18,1994,10,male,517,1000,853,5367,3338,2780,2530,2587,808
2121773,25,20,1988,12,female,162,1020,589,3896,3392,959,1585,2937,1807
2108285,15,11,1998,11,female,499,1222,943,4212,2444,4005,1954,207,490
1953792,18,3,1995,5,female,238,1120,655,5191,2738,4875,1098,316,1640
1794309,18,17,1995,6,female,613,1211,718,3842,1150,3777,763,65,387
1723999,22,5,1991,12,female,529,1014,380,4900,2280,4849,1657,51,623
2001093,16,17,1997,11,female,784,1091,606,8627,5884,6966,4748,1661,1136
1241897,17,31,1996,7,female,352,1047,411,10489,8515,10316,7343,173,1172
1128774,18,16,1995,6,female,1154,1150,513,5726,4183,5484,2333,242,1850
1959140,18,12,1995,8,female,942,1263,702,3793,4487,3730,4245,63,242
1460116,20,18,1993,12,female,543,1084,847,5954,4536,4355,2336,1599,2200
2131320,19,20,1994,1,female,1023,1181,636,5887,3954,4800,1924,1087,2030
1646437,33,23,1980,5,male,1473,1100,742,8749,8059,7086,4784,1663,3275
1267229,24,14,1989,9,female,484,1171,695,14799,22513,12934,17955,1865,4558
1680228,19,13,1994,6,male,612,1026,804,5318,2000,5269,1757,49,243
1732225,25,2,1988,6,female,63,1073,806,3629,2131,3617,1724,12,407
1992740,15,15,1998,5,female,562,1027,817,7616,6771,7578,4390,38,2381
1158610,18,16,1995,2,female,166,1034,683,4843,4485,4808,2111,35,2374
1245068,22,5,1991,12,female,317,1003,760,3832,3196,3812,2730,20,466
1268927,17,7,1996,8,male,619,1099,898,4731,351,4731,294,0,57
1684195,23,14,1990,3,male,529,1056,665,25111,3447,25111,3111,0,336
1220557,35,12,1978,6,male,232,1128,600,7819,1134,7819,1001,0,133
1100061,27,4,1986,2,female,405,1247,853,4523,2423,4523,1948,0,475
1633537,18,14,1995,4,female,318,1014,496,4044,5513,4044,4754,0,759
1720248,18,12,1995,6,female,378,1155,205,3786,3045,3786,2646,0,399
2037447,20,23,1993,5,female,360,1160,668,7447,5547,7447,3756,0,1791
1539043,21,22,1992,4,female,231,1253,835,4110,4714,4110,4258,0,456
2076321,31,2,1982,2,female,223,1019,406,6071,4064,6071,3330,0,734
1960129,14,1,1999,5,male,537,1610,781,102,110,87,55,15,55
1388337,17,19,1996,5,female,358,1310,137,104,407,104,321,0,86
1419745,26,8,1987,10,female,947,1296,191,105,35,28,9,77,26
2104825,20,26,1993,5,female,1621,1560,234,108,224,34,131,74,93
2045305,28,16,1985,3,female,538,1702,994,109,533,108,429,1,104
1827648,21,8,1992,12,female,1019,1566,1319,105,261,105,206,0,55
1790382,18,16,1995,7,female,743,1503,1261,112,482,20,396,92,86
1661790,17,28,1996,2,female,937,1691,477,111,447,72,379,39,68
1430129,18,1,1995,9,female,1136,1357,967,111,399,52,335,59,64
1089611,19,9,1994,10,female,1090,1881,1526,111,823,42,478,69,345
1327533,20,13,1993,9,female,645,1743,437,111,436,50,177,61,259
1576469,17,15,1996,5,female,372,1549,1078,112,736,111,473,1,263
1605280,19,26,1994,4,male,960,1482,1375,116,152,24,120,92,32
2031070,18,7,1995,5,female,241,1497,809,117,280,63,108,54,172
1059447,19,10,1994,7,female,721,1751,1180,115,206,72,160,43,46
1342135,24,17,1989,5,male,688,1529,1360,118,252,48,105,70,147
1446143,17,5,1996,7,female,1028,1761,331,123,416,7,344,116,72
1122358,18,9,1995,2,male,1169,1356,680,123,149,30,121,93,28
1569228,18,30,1995,12,female,311,1287,731,124,81,114,76,10,5
2128469,18,15,1995,8,female,731,1367,847,120,232,103,140,17,92
1543545,16,22,1997,3,female,565,1831,266,124,163,124,95,0,68
1275981,19,12,1994,10,male,754,1357,624,126,362,81,280,45,82
1855501,17,22,1996,3,female,404,1453,1300,130,203,126,171,4,32
1796903,18,1,1995,1,male,586,1354,1017,126,140,125,131,1,9
1151997,26,17,1987,4,male,394,1576,1017,127,480,127,356,0,124
1305202,16,3,1997,2,male,788,1898,379,133,1256,28,524,105,732
1096151,32,25,1981,10,female,713,1375,652,131,156,129,149,2,7
1641404,17,13,1996,6,female,610,1705,1179,132,214,131,91,1,123
1924596,15,6,1998,7,female,234,1640,155,134,204,134,187,0,17
2036104,18,7,1995,10,male,653,1515,838,133,338,133,323,0,15
1061621,21,1,1992,1,female,655,1279,805,136,470,136,429,0,41
1911219,15,31,1998,1,female,458,1493,568,139,193,2,123,137,70
2078617,15,20,1998,12,female,491,1323,949,140,767,118,482,22,285
1268543,21,31,1992,12,male,795,1449,1039,138,50,138,46,0,4
1301981,18,10,1995,4,female,233,1579,324,137,1468,137,1070,0,398
1007037,21,29,1992,2,male,1302,1399,1140,146,70,5,22,141,48
1704226,21,6,1992,11,male,705,1659,1360,147,519,67,300,80,219
1818468,19,28,1994,5,male,1037,1836,1030,147,125,137,101,10,24
1289059,21,8,1992,10,male,817,1451,1195,144,93,127,73,17,20
1422009,21,6,1992,2,female,334,1332,608,147,810,130,205,17,605
1681394,23,16,1990,8,male,545,1435,1285,146,74,146,65,0,9
1804204,18,5,1995,5,female,208,1823,931,147,1352,147,844,0,508
1528119,21,22,1992,2,female,569,1757,1422,149,558,149,465,0,93
1765443,18,12,1995,5,male,916,1395,881,155,203,69,128,86,75
1715506,19,4,1994,6,female,951,1375,943,155,449,98,247,57,202
1989445,22,18,1991,7,female,1506,1295,434,152,261,139,156,13,105
1554160,31,21,1982,10,male,1107,1464,1034,155,746,134,577,21,169
1468087,25,17,1988,10,female,340,1281,1204,154,429,153,296,1,133
1448411,16,8,1997,5,male,231,1533,430,153,1001,153,758,0,243
1207752,16,23,1997,1,female,365,1750,793,164,496,77,321,87,175
1853813,17,12,1996,9,female,670,1484,1163,158,264,111,234,47,30
1295056,21,10,1992,12,male,1601,1806,892,161,314,42,207,119,107
1683757,19,13,1994,11,male,490,1302,1033,162,220,162,152,0,68
1139892,27,4,1986,1,female,72,1413,458,163,215,163,166,0,49
1697569,15,11,1998,8,female,374,1339,340,161,521,161,253,0,268
1683823,19,20,1994,7,female,258,1417,130,169,0,0,0,169,0
1120665,17,18,1996,3,female,825,1484,694,172,303,106,256,66,47
1720881,17,18,1996,7,female,324,1625,545,172,456,147,417,25,39
1508276,23,26,1990,10,male,908,1844,929,165,305,164,262,1,43
1316163,17,3,1996,6,female,460,1655,487,175,1154,175,1067,0,87
1235209,18,29,1995,10,female,378,1692,751,173,1553,173,1428,0,125
1887124,24,12,1989,11,female,214,1812,508,176,302,176,260,0,42
1540907,23,2,1990,1,female,769,1683,624,177,358,177,316,0,42
1117657,19,15,1994,2,female,293,1559,46,183,214,11,171,172,43
1946320,21,14,1992,1,female,1519,1731,305,187,562,28,403,159,159
1588980,19,29,1994,8,male,1350,1332,741,185,200,141,171,44,29
1419975,18,3,1995,1,female,271,1456,341,190,903,189,591,1,312
2000703,19,23,1994,2,female,1348,1661,538,182,604,182,543,0,61
1212688,19,3,1994,5,female,399,1353,962,199,781,4,485,195,296
1227961,21,1,1992,5,male,480,1584,1409,194,541,14,337,180,204
1262399,22,1,1991,10,male,682,1291,917,192,436,82,237,110,199
1164147,35,22,1978,7,male,1174,1627,702,194,1105,110,545,84,560
1045983,18,1,1995,9,female,644,1779,607,197,226,197,189,0,37
1951180,19,1,1994,3,female,735,1311,829,193,127,193,112,0,15
1560355,18,31,1995,7,female,552,1536,1138,195,640,195,583,0,57
2096729,18,10,1995,3,female,821,1831,480,203,98,8,33,195,65
1646755,23,2,1990,4,female,1755,1574,956,208,490,83,268,125,222
1195891,30,25,1983,11,male,542,1270,306,203,185,195,89,8,96
1812585,18,26,1995,3,female,188,1512,177,203,412,203,350,0,62
1508286,20,3,1993,11,male,472,1901,1491,208,447,208,338,0,109
1309365,17,14,1996,9,male,479,1385,1260,215,106,3,81,212,25
1296968,19,7,1994,2,female,418,1872,831,218,815,99,538,119,277
1131896,21,7,1992,11,male,727,1443,359,221,488,54,225,167,263
1919058,20,30,1993,5,male,533,1423,1198,212,1555,66,185,146,1370
2049001,19,1,1994,10,female,666,1430,859,220,146,192,123,28,23
1916981,16,7,1997,1,male,509,1465,1093,215,841,158,355,57,486
1684649,19,19,1994,6,female,1689,1304,174,212,731,171,514,41,217
1680217,15,16,1998,7,female,291,1668,183,219,193,219,70,0,123
1685252,19,12,1994,7,female,1122,1579,1088,224,558,35,247,189,311
1886369,16,13,1997,5,female,911,1442,907,225,513,98,213,127,300
1061868,17,8,1996,2,female,450,1611,953,229,1012,174,835,55,177
1596965,14,10,1999,5,female,568,1554,703,246,198,1,103,245,95
1494138,16,20,1997,6,female,780,1503,916,238,583,59,500,179,83
1112302,24,4,1989,10,female,793,1405,787,243,421,116,294,127,127
1381097,18,7,1995,4,female,464,1298,907,236,948,212,518,24,430
1564821,16,19,1997,3,female,482,1818,289,241,402,240,267,1,135
1185214,18,31,1995,8,female,388,1761,513,234,243,234,230,0,13
1353951,24,9,1989,9,female,268,1563,882,237,477,237,270,0,207
1940186,17,15,1996,9,female,718,1544,1001,257,227,44,60,213,167
1227479,18,26,1995,6,female,50,1702,339,256,507,83,340,173,167
1184725,20,29,1993,1,male,784,1573,741,257,683,174,320,83,363
1972012,17,16,1996,11,female,453,1536,653,248,4,248,3,0,1
1561246,17,27,1996,12,female,287,1356,789,261,211,85,105,176,106
1617497,19,11,1994,9,male,671,1770,1443,272,680,134,478,138,202
2105257,19,23,1994,10,male,361,1394,1242,276,226,260,185,16,41
1874524,19,18,1994,8,male,399,1321,1106,268,38,268,30,0,8
2064185,16,25,1997,12,male,823,1523,1250,278,64,0,39,278,25
1978315,19,3,1994,1,female,1176,1696,1024,284,387,56,198,228,189
1439823,18,3,1995,1,female,588,1800,833,282,1264,18,725,264,539
1181414,21,14,1992,9,male,408,1610,1234,281,731,199,564,82,167
1481513,23,3,1990,9,female,334,1464,590,290,422,220,83,70,339
2161641,16,30,1997,1,male,800,1367,1045,292,2898,243,2228,49,670
1959157,18,9,1995,3,female,317,1412,539,287,1005,273,424,14,581
1299945,18,25,1995,5,female,244,1432,382,286,854,281,578,5,276
2059645,18,11,1995,7,female,410,1367,86,284,536,210,349,74,187
1581805,18,25,1995,5,male,872,1529,771,291,217,291,171,0,46
1027808,19,24,1994,5,female,540,1591,290,291,507,291,371,0,136
1175643,18,7,1995,3,female,1550,1676,767,297,407,184,311,113,96
2105196,14,17,1999,1,female,656,1513,871,308,1570,178,787,130,783
1432225,15,7,1998,6,female,292,1431,1072,302,751,147,406,155,345
2068015,15,13,1998,7,female,803,1728,869,307,1314,70,670,237,644
2096458,19,7,1994,2,female,588,1862,605,298,1283,214,817,84,466
2043368,16,14,1997,11,male,632,1536,1004,304,877,262,793,42,84
2169140,20,22,1993,8,male,651,1633,667,293,465,277,239,16,226
1105579,15,16,1998,6,female,423,1665,603,298,95,298,68,0,27
1108814,17,4,1996,5,male,566,1907,1263,308,68,308,61,0,7
1172137,21,29,1992,2,female,562,1353,979,308,550,308,333,0,217
1047626,17,1,1996,1,female,637,1589,601,312,208,111,105,201,103
1053602,17,1,1996,1,female,605,1684,463,326,276,156,116,170,160
1608257,18,11,1995,1,male,427,1761,1375,312,658,220,307,92,351
1136026,19,17,1994,8,female,973,1773,700,325,1514,291,751,34,763
1569446,27,1,1986,1,female,1540,1770,888,318,834,274,597,44,237
1119326,21,23,1992,2,male,506,1367,1198,314,124,314,115,0,9
1234707,16,20,1997,2,female,363,1470,1197,310,384,310,338,0,46
1636518,19,3,1994,4,male,569,1811,1511,319,214,319,192,0,22
1018319,18,6,1995,6,female,563,1492,972,312,606,312,540,0,66
1361765,14,9,1999,2,female,465,1582,1055,337,1544,98,872,239,672
1044746,19,3,1994,8,female,497,1817,1287,339,723,229,376,110,347
1484839,20,6,1993,11,female,1434,1273,456,331,126,301,81,30,45
1675771,19,21,1994,8,female,587,1305,918,337,529,316,387,21,142
2064303,18,7,1995,4,male,192,1351,1316,336,117,334,76,2,41
1415381,18,7,1995,3,female,277,1886,700,346,861,344,695,2,166
1204897,14,18,1999,1,male,431,1279,826,341,253,341,234,0,19
1421515,18,27,1995,1,female,702,1591,1027,345,223,345,216,0,7
1351959,16,10,1997,11,female,481,1769,947,359,1628,57,738,302,890
1167861,17,4,1996,10,female,974,1824,203,360,570,52,183,308,387
1729347,33,30,1980,7,female,835,1375,1025,349,816,10,511,339,305
1919795,14,19,1999,4,female,585,1446,490,369,738,229,297,140,441
1968021,17,12,1996,9,female,1572,1640,678,361,576,134,241,227,335
1317942,24,19,1989,12,male,793,1587,1197,347,953,196,481,151,472
1218900,17,10,1996,9,male,742,1280,1057,347,341,331,260,16,81
1317941,18,20,1995,4,female,448,1324,860,360,306,328,187,32,119
2093618,20,2,1993,11,female,186,1873,1250,359,263,338,233,21,30
2081030,22,10,1991,8,male,385,1349,803,353,504,333,222,20,282
1786647,17,24,1996,8,male,591,1578,932,349,1083,312,405,37,678
1908406,21,30,1992,6,female,571,1317,425,365,817,269,742,96,75
1673387,17,16,1996,8,female,547,1659,216,349,760,346,338,3,422
1621274,19,1,1994,1,male,887,1315,1037,357,607,357,447,0,160
1007246,23,2,1990,5,male,590,1283,1044,377,478,40,252,337,226
2128844,30,7,1983,7,female,387,1464,468,372,604,17,105,355,499
1910740,16,3,1997,2,female,860,1312,437,388,461,262,257,126,204
1197028,22,6,1991,9,male,620,1529,683,370,413,93,135,277,278
2181868,24,19,1989,5,female,1448,1444,859,373,354,247,194,126,160
1022065,19,16,1994,8,male,1527,1597,1001,393,1236,132,603,261,633
1306117,16,27,1997,7,female,1011,1600,604,379,795,294,620,85,175
2130684,17,3,1996,6,male,1397,1386,847,380,168,379,114,1,54
1359129,15,12,1998,1,female,272,1491,327,376,358,376,308,0,50
1104006,16,9,1997,6,female,217,1681,105,387,1118,387,698,0,420
2075064,19,23,1994,2,male,639,1535,1053,399,521,15,230,384,291
2105387,15,22,1998,1,female,500,1862,366,411,501,130,306,281,195
2026660,15,20,1998,6,female,409,1697,454,410,651,286,244,124,407
1213789,19,15,1994,9,female,1364,1551,639,417,677,166,380,251,297
2102356,19,16,1994,9,female,572,1381,752,395,698,105,293,290,405
2072625,17,17,1996,7,female,226,1483,1024,420,252,383,130,37,122
2012009,17,19,1996,8,female,865,1639,261,408,2660,316,1229,92,1431
2164283,20,20,1993,8,female,679,1780,806,395,1268,373,610,22,658
2126118,17,23,1996,11,female,654,1551,1132,412,101,412,67,0,34
1607163,21,19,1992,7,male,573,1570,1443,413,92,413,53,0,39
1823887,23,24,1990,11,male,617,1465,992,396,292,396,243,0,49
1876515,16,13,1997,5,male,341,1331,818,414,1079,414,682,0,397
1160263,23,4,1990,10,male,337,1572,943,399,1147,399,858,0,289
1585676,18,6,1995,8,male,465,1310,1028,450,140,268,114,182,26
2180403,17,1,1996,4,male,1179,1865,1122,446,1879,212,994,234,885
2187953,18,8,1995,7,female,210,1719,945,450,2170,273,1200,177,970
1432792,19,18,1994,6,male,1297,1374,159,448,5104,231,3446,217,1658
1118410,20,25,1993,9,male,893,1626,522,439,749,200,276,239,473
1916721,22,8,1991,11,female,585,1871,285,428,1416,262,954,166,462
2017668,25,8,1988,10,male,1186,1482,940,445,1303,127,412,318,891
1911986,30,9,1983,12,male,547,1351,671,427,1504,204,551,223,953
1029182,18,18,1995,10,female,613,1501,608,436,446,413,302,23,144
2181440,18,2,1995,4,female,633,1391,718,442,814,416,592,26,222
1948887,19,12,1994,3,male,898,1460,919,423,320,419,305,4,15
1757579,19,30,1994,9,female,509,1383,956,446,665,446,514,0,151
1995794,15,11,1998,8,female,247,1733,29,427,660,427,603,0,57
1674828,23,3,1990,3,female,676,1645,324,433,772,433,699,0,73
1403584,15,10,1998,9,female,436,1331,683,471,674,52,433,419,241
1799207,19,2,1994,5,male,428,1444,959,478,472,50,217,428,255
1308982,18,18,1995,1,male,364,1761,868,481,811,53,422,428,389
2060125,20,19,1993,9,female,949,1872,565,466,1072,66,897,400,175
1943845,19,20,1994,1,male,251,1852,1405,464,1603,301,1002,163,601
1527212,28,15,1985,1,male,1376,1481,512,453,1310,204,1051,249,259
1611296,16,30,1997,5,male,520,1596,1052,483,333,411,243,72,90
1987701,15,17,1998,5,female,459,1480,404,478,3191,373,2194,105,997
1316212,34,18,1979,7,female,1353,1552,225,478,819,463,522,15,297
1391505,20,13,1993,3,male,357,1419,1140,471,285,471,259,0,26
1649732,16,21,1997,8,female,209,1339,669,461,1219,461,1118,0,101
1444475,19,17,1994,8,male,1107,1764,1460,466,786,466,630,0,156
1674096,24,22,1989,5,male,488,1368,1232,462,2511,462,2189,0,322
1858882,21,24,1992,5,female,682,1742,747,513,1805,38,608,475,1197
2153185,41,10,1972,10,female,1474,1351,764,518,204,170,114,348,90
1520366,19,8,1994,1,female,571,1357,425,508,740,178,246,330,494
1107094,17,24,1996,2,female,400,1424,508,498,1043,290,486,208,557
1591583,16,11,1997,1,male,728,1510,1224,502,501,494,393,8,108
1510375,18,17,1995,3,male,645,1777,1083,485,469,471,332,14,137
1862649,18,23,1995,8,female,1194,1302,387,507,1194,427,884,80,310
2181890,20,7,1993,7,male,988,1362,1098,507,159,504,124,3,35
2017494,24,23,1989,4,female,257,1293,1243,509,151,509,141,0,10
1222039,18,18,1995,3,male,368,1629,819,488,347,488,293,0,54
1890773,19,3,1994,5,male,66,1781,963,500,785,500,644,0,141
1664530,24,7,1989,4,female,526,1390,603,552,1242,1,661,551,581
2111553,14,13,1999,1,female,271,1643,651,547,131,302,113,245,18
1509291,15,27,1998,6,male,214,1822,444,551,222,246,70,305,152
1204210,17,25,1996,10,male,1100,1651,1243,530,461,168,173,362,288
1696866,21,29,1992,4,male,674,1291,652,528,554,206,366,322,188
1082336,29,21,1984,11,female,616,1527,557,532,421,261,167,271,254
1336182,21,20,1992,3,male,1126,1649,1337,541,1057,371,676,170,381
1961998,22,28,1991,11,male,268,1750,1435,526,33,456,27,70,6
1908985,17,8,1996,11,female,1300,1347,302,542,125,487,71,55,54
2047981,25,17,1988,12,male,589,1668,1215,557,728,434,493,123,235
1999826,16,8,1997,5,male,45,1850,123,561,3885,414,2325,147,1560
1815780,26,9,1987,5,male,1546,1525,1040,536,477,531,282,5,195
1306529,20,24,1993,10,female,492,1473,80,526,243,526,184,0,59
1531054,17,25,1996,11,male,475,1673,1458,554,376,554,267,0,109
1444360,14,10,1999,8,female,401,1354,632,570,128,55,63,515,65
1333505,17,22,1996,12,female,1546,1524,776,575,1046,125,443,450,603
1375189,23,26,1990,1,male,1045,1902,172,578,1028,390,626,188,402
1712392,15,13,1998,2,female,580,1542,1072,570,390,475,96,95,294
1419994,19,14,1994,6,female,589,1437,313,576,392,427,215,149,177
1953464,20,4,1993,5,female,1693,1775,570,579,659,530,310,49,349
1456627,16,24,1997,6,male,761,1374,960,581,1199,562,803,19,396
1253931,36,19,1977,11,male,1746,1759,1005,569,1045,536,816,33,229
1157762,18,6,1995,7,female,195,1446,1355,563,312,561,243,2,69
1202483,17,14,1996,12,female,77,1808,225,593,328,593,199,0,129
1601015,19,10,1994,4,male,347,1594,757,587,542,587,509,0,33
1889150,16,23,1997,6,male,509,1357,1168,652,94,8,13,644,81
1379191,29,26,1984,2,male,524,1819,1495,610,366,10,199,600,167
1996691,19,28,1994,9,female,502,1375,837,651,404,44,175,607,229
2054255,17,31,1996,5,male,194,1526,964,626,1229,6,984,620,245
1101956,18,14,1995,6,male,923,1910,494,615,5645,18,4269,597,1376
1530580,39,5,1974,3,female,1472,1394,638,639,166,189,83,450,83
1500556,42,3,1971,6,female,1541,1374,792,624,245,438,154,186,91
1465198,19,3,1994,12,female,1590,1878,708,626,480,205,181,421,299
1184479,15,25,1998,1,female,569,1450,589,614,2925,364,1375,250,1550
1511094,15,11,1998,8,female,425,1658,380,648,2269,411,1537,237,732
1537736,19,10,1994,9,female,1308,1671,637,631,2912,253,1369,378,1543
1976866,27,4,1986,5,female,1082,1383,226,611,1316,405,404,206,912
1815761,19,20,1994,3,female,422,1856,1039,646,359,633,215,13,144
1461991,18,24,1995,12,male,148,1282,1070,632,570,542,466,90,104
1323658,21,22,1992,3,female,1184,1427,718,615,566,539,235,76,331
1143206,22,20,1991,3,female,744,1411,795,647,910,574,491,73,419
1985688,17,14,1996,5,female,929,1763,823,657,849,657,684,0,165
1707201,16,15,1997,3,female,214,1782,453,638,1109,638,824,0,285
1808733,18,29,1995,12,female,840,1600,1152,661,2686,661,2421,0,265
2067103,14,20,1999,3,female,349,1436,853,682,636,74,334,608,302
1281860,15,9,1998,7,female,617,1465,758,666,1784,64,347,602,1437
2156090,18,21,1995,2,male,433,1479,696,670,873,445,686,225,187
1891942,19,24,1994,5,male,935,1385,738,712,649,167,105,545,544
1314104,19,7,1994,4,female,1552,1401,319,714,28053,346,18648,368,9405
1590815,22,12,1991,3,female,429,1393,96,686,1964,434,782,252,1182
1619701,20,1,1993,4,female,592,1347,968,708,277,679,213,29,64
1015496,23,5,1990,3,male,822,1560,912,677,384,595,238,82,146
1767168,22,24,1991,7,male,265,1729,1348,684,548,530,366,154,182
1926359,22,6,1991,10,female,1259,1312,582,664,1295,531,584,133,711
2140008,17,13,1996,3,female,651,1273,515,668,257,668,219,0,38
1535995,15,21,1998,2,female,554,1455,880,759,281,76,103,683,178
1841154,26,22,1987,7,male,1188,1661,718,767,873,81,533,686,340
1500650,19,27,1994,12,male,435,1380,1120,775,213,250,189,525,24
1376169,18,5,1995,12,female,121,1712,1086,777,999,530,615,247,384
1687407,19,27,1994,5,female,605,1357,309,727,932,207,354,520,578
1030498,20,12,1993,8,female,757,1432,910,740,870,286,367,454,503
1662762,17,5,1996,10,female,603,1407,566,736,2348,390,1685,346,663
1078644,18,4,1995,1,female,999,1880,597,737,2202,244,750,493,1452
1138442,18,3,1995,7,male,131,1422,695,746,3569,430,2051,316,1518
1268878,18,20,1995,10,female,424,1596,1264,735,1379,411,1169,324,210
1250623,16,24,1997,12,female,817,1353,399,727,2293,704,1514,23,779
1669677,22,29,1991,5,female,667,1842,619,730,1428,563,1081,167,347
1339487,18,16,1995,2,male,420,1557,1164,733,964,730,877,3,87
2166102,23,11,1990,7,female,1137,1486,829,778,2203,772,1313,6,890
2100389,19,8,1994,9,male,527,1740,1493,779,385,779,313,0,72
1490362,15,18,1998,2,female,378,1333,939,787,806,787,692,0,114
1825204,24,31,1989,7,female,1618,1532,511,757,688,757,596,0,92
2148873,18,16,1995,6,female,297,1421,837,775,1518,775,1185,0,333
1919917,20,30,1993,10,female,494,1675,1167,858,265,52,226,806,39
1482449,15,11,1998,9,female,565,1641,658,867,1028,126,236,741,792
1542562,17,7,1996,7,female,609,1627,437,852,754,0,148,852,606
1102074,17,16,1996,11,male,399,1403,181,821,1399,115,467,706,932
1488206,19,17,1994,1,male,177,1290,1136,846,2789,119,929,727,1860
1922878,19,12,1994,6,male,224,1587,177,802,3164,0,470,802,2694
1657732,18,29,1995,12,female,762,1516,583,831,524,403,147,428,377
1928067,19,4,1994,11,female,190,1747,131,851,1132,381,597,470,535
1074912,18,5,1995,3,female,564,1733,865,849,1170,239,681,610,489
1689015,19,29,1994,7,female,392,1525,971,835,1082,575,629,260,453
1494452,26,29,1987,7,female,1063,1656,536,848,4223,250,3209,598,1014
2026420,16,3,1997,9,female,554,1614,972,877,468,759,293,118,175
1912654,22,20,1991,7,female,1718,1289,750,856,478,668,428,188,50
2021868,14,11,1999,2,female,416,1423,695,836,862,821,444,15,418
1301924,18,5,1995,2,female,611,1663,240,854,649,640,331,214,318
1850436,18,19,1995,7,female,440,1377,1075,857,999,650,686,207,313
2044224,22,19,1991,12,male,671,1533,967,809,5895,683,2593,126,3302
1684493,22,2,1991,6,male,819,1503,636,842,1689,825,1094,17,595
1872125,16,29,1997,4,female,503,1519,411,869,3623,863,3090,6,533
1942818,18,16,1995,6,male,665,1771,1287,803,343,803,298,0,45
1520751,27,5,1986,4,male,1179,1900,1636,831,347,831,262,0,85
1956816,22,22,1991,8,male,583,1470,1030,851,531,851,501,0,30
2105121,15,6,1998,7,female,571,1741,691,862,5029,862,3719,0,1310
2137224,19,12,1994,10,female,370,1826,661,825,1536,825,1398,0,138
1569650,19,21,1994,7,male,400,1724,1112,895,998,52,771,843,227
2055991,15,11,1998,11,female,466,1843,1133,974,1469,142,427,832,1042
1696338,16,19,1997,11,female,233,1324,726,938,2010,147,748,791,1262
1753554,15,1,1998,10,female,323,1314,977,887,982,276,314,611,668
1718708,16,16,1997,4,male,844,1593,1062,905,1338,188,822,717,516
1959613,16,16,1997,8,female,323,1476,997,964,654,224,205,740,449
1710550,19,22,1994,11,female,638,1277,633,935,1079,226,212,709,867
1169809,23,9,1990,6,male,253,1278,945,959,1033,632,524,327,509
1285683,20,7,1993,5,male,484,1393,754,982,3473,373,2152,609,1321
1866697,20,16,1993,9,male,713,1862,390,913,1960,342,977,571,983
1813217,30,10,1983,10,female,443,1731,1293,914,5102,216,2301,698,2801
2185997,19,10,1994,10,male,250,1418,1002,948,625,803,366,145,259
1480887,20,21,1993,10,male,493,1342,412,896,825,831,423,65,402
1187043,15,3,1998,6,female,149,1524,585,958,4387,932,2323,26,2064
1396641,22,16,1991,10,female,1043,1905,832,911,1191,911,900,0,291
1338461,18,16,1995,7,male,141,1676,1279,900,2775,900,2252,0,523
1087417,33,1,1980,1,female,606,1909,118,956,4027,956,3550,0,477
1839631,16,8,1997,5,female,885,1706,618,1125,983,25,386,1100,597
1990018,20,11,1993,11,male,872,1454,590,1061,870,181,630,880,240
1044950,18,20,1995,6,female,1127,1869,296,1013,786,533,336,480,450
1762430,37,28,1976,4,female,1121,1282,1011,1007,845,461,246,546,599
1800069,15,12,1998,3,female,1673,1871,835,1029,2375,491,1927,538,448
1602002,18,6,1995,6,female,522,1439,1092,1037,1996,358,1381,679,615
1844398,18,1,1995,11,male,344,1342,602,1060,3328,465,1953,595,1375
1163700,19,29,1994,1,female,458,1413,448,1117,2104,679,824,438,1280
1399231,20,12,1993,10,female,1619,1781,694,1047,7615,600,4545,447,3070
1149125,18,23,1995,12,male,1037,1373,709,1001,630,956,453,45,177
1809403,20,22,1993,8,female,945,1513,665,1064,1912,1053,1760,11,152
1377722,20,12,1993,9,female,262,1552,636,1032,1761,1022,1132,10,629
1837240,16,9,1997,9,female,368,1285,939,1097,401,1097,326,0,75
2137677,18,12,1995,4,female,209,1364,207,1086,241,1086,139,0,102
1902387,19,9,1994,8,male,489,1807,1373,1059,1388,1059,1310,0,78
1217521,18,28,1995,4,female,681,1440,817,999,1714,999,1056,0,658
1463457,15,1,1998,3,female,752,1604,1035,1190,2166,177,975,1013,1191
1364825,16,8,1997,5,male,473,1476,1321,1224,47,298,33,926,14
1291714,16,18,1997,8,female,748,1288,601,1227,1214,768,660,459,554
1564990,19,10,1994,5,female,1325,1446,367,1249,1149,496,420,753,729
2126255,20,22,1993,9,female,1078,1795,1247,1210,3720,798,1731,412,1989
1859410,17,29,1996,12,male,129,1469,1430,1154,202,921,154,233,48
1349202,21,18,1992,3,female,605,1628,483,1163,942,907,699,256,243
2131388,24,20,1989,8,female,430,1861,818,1268,201,1268,188,0,13
1311351,22,7,1991,12,female,412,1326,651,1133,1968,1133,666,0,1302
1566240,20,6,1993,4,female,318,1276,841,1483,1037,284,217,1199,820
1107316,23,16,1990,4,female,61,1481,1029,1319,859,202,352,1117,507
1702451,16,9,1997,1,female,431,1361,351,1472,552,657,243,815,309
1381225,18,27,1995,12,female,416,1596,1167,1514,710,399,472,1115,238
1581307,20,16,1993,9,male,2026,1863,1315,1290,548,787,200,503,348
1205714,23,3,1990,12,female,664,1831,840,1298,549,537,170,761,379
1245069,16,7,1997,11,male,336,1768,1132,1326,1394,835,875,491,519
1313112,15,22,1998,9,female,795,1586,705,1378,1743,529,1011,849,732
1521843,39,25,1974,4,male,766,1387,628,1332,1944,476,857,856,1087
1446107,14,14,1999,2,male,555,1319,1083,1333,2260,780,833,553,1427
1325929,15,23,1998,4,female,834,1473,342,1414,2829,384,1289,1030,1540
1541513,16,5,1997,3,male,240,1430,1226,1333,614,1310,505,23,109
2036967,20,20,1993,9,female,1118,1450,710,1305,1939,1059,1376,246,563
1199611,21,9,1992,7,female,1218,1704,372,1316,1872,1301,1617,15,255
1449449,23,25,1990,1,male,1767,1715,791,1304,1251,1226,861,78,390
1419811,33,15,1980,11,female,529,1644,992,1396,1970,1255,1539,141,431
2095545,18,12,1995,6,male,870,1505,1267,1450,249,1450,239,0,10
1432222,25,5,1988,2,female,624,1626,441,1309,1130,1309,982,0,148
2176917,33,26,1980,10,female,825,1896,837,1369,2518,1369,2355,0,163
1796734,16,15,1997,7,female,219,1439,937,1747,1810,56,416,1691,1394
1501765,20,2,1993,10,male,223,1320,895,1648,1202,219,773,1429,429
1627957,21,9,1992,4,male,504,1747,511,1869,1271,244,780,1625,491
1218807,21,7,1992,4,male,858,1277,790,1750,3205,238,1237,1512,1968
1912174,14,25,1999,2,female,470,1658,431,1630,837,340,328,1290,509
1138775,16,19,1997,8,female,617,1406,782,1565,665,600,317,965,348
1488396,31,4,1982,3,male,591,1906,1023,1566,788,578,312,988,476
2143416,15,18,1998,11,female,663,1756,463,1752,1230,1083,624,669,606
1946197,15,25,1998,4,male,1079,1601,1286,1762,1229,404,762,1358,467
1968078,16,22,1997,2,female,859,1639,390,1828,2275,1086,1835,742,440
1647904,17,26,1996,6,male,1264,1846,1078,1637,1068,1082,613,555,455
2193190,19,29,1994,10,female,569,1681,557,1621,1457,672,668,949,789
2135050,26,22,1987,5,male,953,1449,689,1732,1887,662,1061,1070,826
1319501,18,12,1995,4,female,305,1580,668,1590,2710,377,638,1213,2072
1323979,23,30,1990,8,female,590,1697,656,1530,3780,420,1007,1110,2773
1782252,16,1,1997,9,female,284,1672,1230,1800,38,1400,29,400,9
2167585,18,22,1995,12,male,1003,1328,1022,1595,397,1489,351,106,46
1265766,18,5,1995,11,female,195,1456,686,1572,1516,1541,605,31,911
1485394,18,4,1995,5,male,347,1780,1344,1761,2225,1722,1953,39,272
1420221,19,18,1994,10,female,608,1441,604,1606,1104,1548,952,58,152
1112008,20,8,1993,8,female,1591,1855,744,1689,1416,1355,729,334,687
1672543,28,17,1985,9,female,2195,1386,449,1609,981,1494,542,115,439
1786722,13,25,2000,1,female,664,1832,705,1595,2458,1356,1824,239,634
1426705,20,8,1993,12,female,877,1562,175,1691,2934,1342,2155,349,779
1532366,19,16,1994,1,female,185,1516,415,1744,2908,1636,2589,108,319
1345802,20,5,1993,4,female,1532,1798,472,1562,3361,1143,1526,419,1835
1743401,24,2,1989,5,male,1465,1722,1229,1827,744,1825,599,2,145
1461440,16,13,1997,7,male,247,1565,955,1744,1664,1743,1278,1,386
1755401,18,26,1995,4,female,277,1801,739,1603,1824,1599,1357,4,467
1291098,16,8,1997,10,female,499,1860,181,1550,2537,1547,2391,3,146
1040715,19,9,1994,6,male,367,1675,1301,1799,296,1799,289,0,7
1066951,23,14,1990,11,male,389,1833,1342,1602,884,1602,805,0,79
1475750,17,15,1996,12,female,267,1280,215,1784,1423,1784,844,0,579
1562451,21,18,1992,10,female,387,1467,615,1771,1599,1771,1303,0,296
1162406,15,10,1998,5,male,210,1581,1271,2205,1700,230,623,1975,1077
1533828,21,13,1992,8,female,793,1753,1090,2314,1724,215,855,2099,869
1633413,15,12,1998,9,female,1349,1556,624,2055,5115,321,3222,1734,1893
1114450,16,16,1997,1,male,775,1338,1147,2118,3215,407,1604,1711,1611
1860624,14,29,1999,7,female,819,1293,675,2202,915,1201,314,1001,601
1049398,16,15,1997,5,female,992,1517,542,2203,803,1580,483,623,320
2048904,18,7,1995,4,male,1328,1738,1181,2013,535,818,276,1195,259
1875575,16,27,1997,2,female,544,1378,535,2241,3211,581,1400,1660,1811
1625694,16,29,1997,5,female,546,1733,1055,2277,3119,973,1830,1304,1289
1973975,17,2,1996,3,male,1317,1347,780,2262,1964,1277,1143,985,821
1926124,19,18,1994,12,female,421,1674,356,1981,2515,460,864,1521,1651
1421010,19,19,1994,6,female,665,1893,1248,2112,1287,1499,782,613,505
1860809,19,26,1994,8,female,470,1676,656,2247,2506,711,1101,1536,1405
1818772,18,26,1995,10,female,622,1522,888,2059,3779,876,1436,1183,2343
1287273,19,18,1994,3,male,569,1319,721,2323,5662,959,2292,1364,3370
1216467,19,24,1994,5,female,1091,1382,473,2169,4623,1277,1120,892,3503
1561449,21,27,1992,5,female,231,1682,470,2295,4190,904,1352,1391,2838
1211213,34,2,1979,6,male,773,1541,1175,2177,1295,2002,1120,175,175
1244687,16,18,1997,2,female,207,1466,783,2319,1765,1824,986,495,779
1366254,16,14,1997,4,male,596,1347,814,2106,1457,1699,1024,407,433
1796866,16,28,1997,5,female,1135,1535,364,2203,3048,1901,2733,302,315
2047291,18,9,1995,5,female,778,1295,978,2354,3160,1989,2526,365,634
1295174,19,23,1994,2,female,680,1297,172,2083,3048,2049,2431,34,617
1708106,20,22,1993,2,female,991,1488,929,2287,2014,2215,1225,72,789
1605373,30,9,1983,12,female,950,1394,815,2081,1288,1532,963,549,325
1838332,17,10,1996,5,female,1038,1567,513,2042,3116,1593,1769,449,1347
1808104,22,8,1991,3,female,1069,1430,696,2133,17495,1883,8651,250,8844
2018305,20,31,1993,5,female,944,1514,662,2184,2482,2162,2125,22,357
2118698,17,4,1996,9,female,392,1447,741,1932,2920,1925,1637,7,1283
1309633,18,10,1995,10,female,282,1596,1104,2248,3961,2247,2150,1,1811
1354456,16,20,1997,7,male,460,1467,998,2241,302,2241,172,0,130
1717083,18,16,1995,2,male,274,1748,843,2122,337,2122,303,0,34
1943866,26,5,1987,3,female,589,1400,761,2132,350,2132,264,0,86
1057548,17,22,1996,11,female,1003,1686,432,2067,571,2067,428,0,143
1050029,17,8,1996,11,male,485,1343,1130,2239,805,2239,515,0,290
1494045,25,12,1988,8,male,904,1311,916,2264,2280,2264,2056,0,224
2129408,24,1,1989,9,female,499,1650,412,2230,8340,2230,7170,0,1170
1601323,18,1,1995,1,female,365,1500,1154,2432,3482,432,1011,2000,2471
1282426,23,10,1990,11,male,779,1575,909,2580,1944,276,1553,2304,391
1644936,18,14,1995,5,female,236,1422,191,2890,5272,320,2043,2570,3229
1938843,19,12,1994,9,female,1586,1321,508,3569,7031,368,6229,3201,802
1957156,20,24,1993,9,female,572,1746,830,2985,5786,594,4843,2391,943
1384573,14,1,1999,6,female,431,1491,1069,3368,1996,1000,547,2368,1449
1109912,16,18,1997,2,female,1027,1625,987,3330,1509,1843,624,1487,885
1167635,19,21,1994,12,female,651,1338,611,3065,1585,1901,738,1164,847
1223972,23,10,1990,12,male,1435,1570,688,2682,1099,1259,715,1423,384
1810531,27,16,1986,6,female,918,1315,723,2641,956,991,595,1650,361
2088893,15,23,1998,9,female,442,1859,1187,2906,2356,1170,1860,1736,496
1449153,17,2,1996,7,female,301,1656,331,2549,2188,1345,1416,1204,772
2165949,18,20,1995,6,female,1368,1807,856,2407,2911,1112,2088,1295,823
1798537,19,15,1994,5,female,1012,1591,1222,3285,2274,2016,1376,1269,898
1691605,19,4,1994,7,male,727,1623,1217,3301,4734,796,2917,2505,1817
1279706,36,24,1977,11,female,496,1270,542,2418,2487,860,667,1558,1820
1617206,15,10,1998,1,female,821,1586,1090,2671,16936,1461,8420,1210,8516
1084319,18,31,1995,5,male,437,1588,1207,2711,1187,2123,1051,588,136
1392135,19,17,1994,6,female,609,1283,800,2720,1430,2472,1270,248,160
1521275,15,24,1998,12,female,821,1296,441,2686,2698,2349,1421,337,1277
1572419,17,1,1996,1,male,552,1478,935,2749,2220,2610,2014,139,206
1597241,18,17,1995,3,female,324,1485,111,2771,1721,2329,985,442,736
1208672,16,9,1997,12,female,150,1724,172,2542,4763,1895,2657,647,2106
1344521,18,9,1995,2,female,437,1822,870,3181,5459,2413,3432,768,2027
1905014,18,10,1995,8,female,475,1706,665,2642,6140,2473,3363,169,2777
1173275,19,31,1994,3,female,242,1307,936,2799,5365,2518,4485,281,880
1425934,20,29,1993,8,male,393,1456,381,2551,3864,2219,1847,332,2017
1368458,14,21,1999,2,female,481,1352,462,3214,598,3212,484,2,114
1568305,28,14,1985,6,female,484,1539,954,2914,24229,2913,16072,1,8157
1489177,18,12,1995,5,female,253,1409,533,2779,1624,2779,1351,0,273
1202463,27,2,1986,11,male,1369,1341,957,2878,1738,2878,1616,0,122
1674338,26,3,1987,8,male,855,1824,1349,3101,590,3101,328,0,262
2001034,28,28,1985,3,male,536,1444,928,3132,1269,3132,969,0,300
1079321,18,1,1995,1,female,578,1288,434,2748,2882,2748,2422,0,460
1342941,25,13,1988,11,male,1054,1784,1160,2641,1909,2641,1759,0,150
1806696,15,17,1998,2,female,448,1307,855,10803,5454,40,3907,10763,1547
1754892,24,7,1989,9,female,418,1379,719,4633,2592,455,1420,4178,1172
1739198,15,22,1998,12,female,563,1767,838,4185,5807,437,1971,3748,3836
1288654,18,11,1995,3,male,361,1750,603,6455,5105,359,1529,6096,3576
2063032,19,24,1994,5,female,448,1294,271,4267,2623,473,1912,3794,711
1820513,20,8,1993,7,female,1092,1282,936,11130,8704,591,4419,10539,4285
1386285,18,15,1995,9,female,443,1567,663,5620,20704,220,9694,5400,11010
1034148,17,11,1996,8,female,499,1652,959,6267,3625,2795,2076,3472,1549
1665822,23,24,1990,2,female,508,1423,577,8205,4121,4550,2065,3655,2056
2109614,23,4,1990,2,female,473,1767,1446,3599,1827,2255,901,1344,926
1125963,15,23,1998,12,female,1168,1854,833,4981,3050,2300,1286,2681,1764
1772336,17,20,1996,3,female,1270,1458,1039,5494,4388,1400,1974,4094,2414
2185689,18,18,1995,3,female,99,1607,621,5654,6072,3823,5016,1831,1056
2142811,20,15,1993,11,female,1537,1722,1017,4501,6016,2464,1999,2037,4017
2179210,20,11,1993,12,female,370,1837,740,6916,9643,2296,6543,4620,3100
2190354,22,12,1991,12,male,762,1280,515,4442,3338,2804,2438,1638,900
1731072,21,25,1992,10,female,1263,1602,1085,8721,12938,3023,5559,5698,7379
1636713,24,20,1989,9,female,569,1371,544,6593,5944,2189,3825,4404,2119
1950549,38,22,1975,6,female,2244,1291,250,4831,3610,3446,3019,1385,591
1332241,15,22,1998,6,female,294,1789,606,4000,6212,2821,4392,1179,1820
1652225,18,17,1995,7,female,773,1274,364,3925,8398,865,4104,3060,4294
1801536,17,14,1996,10,female,270,1340,1021,4915,2496,3984,1076,931,1420
1956429,18,5,1995,5,male,541,1392,1231,4303,1704,3784,1547,519,157
2034020,18,10,1995,7,female,526,1533,422,7799,4520,7547,3534,252,986
1087168,18,12,1995,7,male,514,1557,1132,4750,2497,4504,1788,246,709
1187594,21,10,1992,11,female,1104,1388,774,4914,2192,4399,1985,515,207
1880144,23,16,1990,2,female,338,1289,897,4005,983,3946,698,59,285
1878566,29,22,1984,5,female,829,1570,1030,13692,3114,12639,2010,1053,1104
1618900,21,27,1992,4,male,267,1874,564,4080,5791,3148,3798,932,1993
2068345,22,18,1991,6,male,553,1365,793,5561,4742,5267,2195,294,2547
2033044,25,9,1988,6,female,329,1315,1003,11257,13397,8802,8506,2455,4891
1996736,18,7,1995,2,female,459,1643,570,4334,7737,3709,4781,625,2956
1554413,18,19,1995,3,female,1075,1848,850,12172,30222,10479,16944,1693,13278
2126022,39,29,1974,11,male,947,1729,589,10115,18110,9961,10735,154,7375
1999852,18,19,1995,10,female,655,1384,295,6334,1293,6294,758,40,535
1825900,32,3,1981,1,female,441,1804,366,6320,6808,6286,4659,34,2149
1115903,17,4,1996,4,male,301,1281,647,5831,3344,5831,2979,0,365
2052324,23,5,1990,12,male,427,1519,1339,3874,5216,3874,4329,0,887
1066764,23,7,1990,4,female,291,1728,660,3897,4233,3897,3899,0,334
1042399,28,29,1985,10,female,832,1314,482,5958,5595,5958,4978,0,617
1767540,29,25,1984,5,female,290,1761,72,6809,8757,6809,7905,0,852
1360671,16,25,1997,7,female,804,1987,1113,101,660,31,478,70,182
1189003,19,1,1994,1,female,583,2661,708,103,294,56,253,47,41
1078313,17,26,1996,6,female,577,4584,2196,108,682,1,390,107,292
1338883,18,5,1995,11,female,139,3080,278,106,769,59,544,47,225
2180017,17,17,1996,2,female,658,3525,1896,105,3167,39,1772,66,1395
1719894,17,13,1996,6,female,1104,4662,1391,108,2477,74,1512,34,965
1053589,19,8,1994,6,female,454,1985,519,107,9,80,1,27,8
1400630,19,24,1994,6,female,506,2749,437,106,554,94,415,12,139
1897311,18,31,1995,12,female,138,3348,480,105,285,105,275,0,10
1122188,25,15,1988,3,female,403,2095,293,109,3148,109,2434,0,714
1285799,16,27,1997,3,male,554,2344,1404,112,134,5,98,107,36
1539861,16,11,1997,11,male,644,2669,2195,111,1515,16,978,95,537
1430882,16,9,1997,4,female,685,1966,390,110,13,110,13,0,0
1804255,18,17,1995,10,female,682,3989,260,119,596,119,460,0,136
1979055,22,20,1991,4,female,1036,2014,152,118,3129,118,2865,0,264
1175550,15,23,1998,2,female,632,4475,750,120,500,39,260,81,240
2163894,17,5,1996,1,male,616,2410,1329,122,26,122,22,0,4
1286620,18,10,1995,9,female,481,2066,550,124,313,124,263,0,50
1292089,20,16,1993,6,female,1067,4607,1336,128,467,6,168,122,299
2154380,19,14,1994,7,female,1409,3441,2075,128,389,38,196,90,193
1163502,36,27,1977,9,male,2258,2561,1711,127,1893,47,1442,80,451
2138779,16,4,1997,5,female,604,2883,325,126,86,100,51,26,35
1742536,14,24,1999,8,female,246,2424,1728,128,159,128,153,0,6
1943844,24,28,1989,12,female,525,2046,521,127,266,127,211,0,55
1934998,15,27,1998,4,female,701,2043,137,135,541,135,378,0,163
1182720,19,17,1994,1,female,1101,4252,958,142,706,134,507,8,199
1383071,20,29,1993,6,male,549,2633,213,137,4959,101,2791,36,2168
1033100,17,27,1996,11,female,290,2283,420,141,1989,141,1285,0,704
2038656,17,28,1996,3,female,399,2495,765,143,3045,143,2445,0,600
1561009,18,11,1995,9,female,404,2973,979,137,240,137,220,0,20
1684159,17,22,1996,12,female,120,3504,782,147,373,144,307,3,66
1838288,20,14,1993,11,female,165,1964,99,146,1706,146,1547,0,159
1758272,22,16,1991,12,male,445,4037,1704,147,2997,147,2419,0,578
1640650,18,29,1995,7,female,1581,1940,897,156,1151,52,89,104,1062
1127838,21,21,1992,10,female,881,4767,1240,151,599,108,251,43,348
1126316,23,3,1990,10,male,314,3637,281,154,1142,112,900,42,242
1949609,27,30,1986,4,female,1416,3561,1039,151,754,151,365,0,389
1730678,19,11,1994,9,male,1561,3131,970,163,1228,17,576,146,652
1371642,15,7,1998,9,female,555,1926,613,161,570,57,176,104,394
2110108,25,26,1988,2,male,665,2396,714,163,198,163,176,0,22
1148138,18,20,1995,10,female,362,1948,297,159,776,159,644,0,132
1038541,17,8,1996,9,female,757,2600,1148,165,183,104,149,61,34
1415176,15,8,1998,12,female,593,3459,1068,166,836,56,533,110,303
1260745,19,19,1994,6,male,278,2931,725,165,470,48,267,117,203
2119798,21,4,1992,7,female,1380,3095,333,168,495,137,382,31,113
1824450,23,19,1990,10,male,272,4274,100,170,3488,169,2861,1,627
1403953,19,11,1994,11,male,519,3693,3415,170,20,170,19,0,1
1092658,17,13,1996,1,male,376,3513,359,172,208,172,193,0,15
1617593,19,6,1994,4,female,404,3529,1919,166,491,166,356,0,135
1945705,17,1,1996,1,female,882,3357,978,177,314,119,211,58,103
1439214,33,27,1980,10,male,266,4792,42,177,1052,153,639,24,413
1401648,16,25,1997,12,female,135,2107,484,177,401,177,285,0,116
2025725,17,21,1996,3,female,702,4701,1130,184,4803,47,1561,137,3242
1501174,20,10,1993,10,male,914,2434,711,184,1022,86,878,98,144
1107829,18,20,1995,6,male,452,2587,1247,184,269,167,206,17,63
1063247,19,30,1994,12,female,826,2826,552,196,1280,146,387,50,893
2007684,18,12,1995,2,female,617,4384,669,196,328,196,293,0,35
2058804,14,24,1999,2,female,404,2451,921,210,891,1,291,209,600
1166773,17,2,1996,11,male,1174,1974,1111,203,739,32,221,171,518
1137301,19,13,1994,3,female,1767,4302,754,203,1006,18,451,185,555
1769821,19,13,1994,2,female,608,4507,296,202,1185,144,702,58,483
1855389,17,10,1996,1,female,1206,3430,1039,205,1596,192,1055,13,541
1357077,21,26,1992,6,male,952,2766,1931,216,225,156,174,60,51
1718739,39,20,1974,9,male,616,2028,351,221,1087,143,357,78,730
1942093,19,5,1994,9,male,653,3623,856,215,6699,162,5111,53,1588
1166085,20,31,1993,8,female,463,4180,649,212,2001,160,982,52,1019
2040681,21,2,1992,3,female,1369,3716,596,221,1726,204,1177,17,549
1832848,23,4,1990,9,female,1627,3095,474,222,312,1,218,221,94
1112584,27,11,1986,11,male,1349,2936,2637,222,43,72,28,150,15
1398239,17,12,1996,7,female,545,2154,159,230,199,152,121,78,78
1349746,16,3,1997,9,male,197,4190,1170,230,1703,133,1339,97,364
2033463,18,24,1995,6,female,551,3014,1028,226,3037,182,1809,44,1228
1820520,18,1,1995,4,female,1263,1983,309,231,711,229,221,2,490
1255687,21,10,1992,10,male,408,1925,1410,224,99,224,57,0,42
1119831,18,25,1995,9,female,570,3475,546,233,1576,233,1456,0,120
1306533,20,1,1993,11,female,680,3273,775,228,1226,228,1011,0,215
1517807,17,30,1996,7,female,394,2590,1240,245,486,1,152,244,334
1973701,17,5,1996,9,female,1436,3299,441,236,667,16,123,220,544
1738053,18,30,1995,11,female,353,2022,1144,241,131,147,50,94,81
1692860,21,20,1992,12,female,1165,3257,501,240,2277,144,1528,96,749
1324261,19,5,1994,5,female,1554,3874,1618,243,1046,190,457,53,589
1831130,16,2,1997,3,female,624,2218,500,241,114,241,99,0,15
1541529,17,20,1996,10,female,590,2053,836,244,685,244,479,0,206
1476864,16,15,1997,7,female,313,4578,399,253,6118,10,3526,243,2592
2041740,17,19,1996,1,female,556,2302,835,249,371,145,106,104,265
1641987,19,12,1994,4,male,1440,2564,1394,248,314,88,184,160,130
2031089,16,29,1997,5,male,615,2690,860,247,607,90,368,157,239
1208589,20,8,1993,12,male,640,2141,881,251,738,179,218,72,520
1733618,17,20,1996,11,female,540,1955,987,249,54,229,25,20,29
1468499,18,15,1995,6,male,728,2609,2085,251,283,248,246,3,37
2141603,20,11,1993,5,male,517,2983,2772,253,1763,245,1544,8,219
2018614,17,16,1996,12,female,516,4282,1192,251,1115,251,665,0,450
1005698,16,14,1997,1,male,212,3869,565,252,407,252,337,0,70
1803948,34,23,1979,8,female,392,2308,242,254,1071,254,915,0,156
1054433,23,9,1990,11,female,1018,1985,251,269,1608,48,1239,221,369
2058557,15,9,1998,1,female,657,3194,1017,268,767,89,452,179,315
1014347,18,5,1995,3,male,834,3121,1721,270,1958,63,739,207,1219
1595032,18,18,1995,3,female,1031,4085,1454,274,618,272,452,2,166
1149553,23,9,1990,12,male,710,2034,1151,268,143,268,135,0,8
1533729,19,3,1994,11,female,1387,2780,551,266,818,266,741,0,77
1916745,18,10,1995,8,female,322,2382,670,276,802,276,727,0,75
2127584,16,14,1997,9,female,744,2427,1436,282,3317,15,2111,267,1206
1446210,17,22,1996,2,female,309,4540,454,290,2047,4,1279,286,768
1535023,19,9,1994,9,male,222,3847,259,278,2145,2,1447,276,698
1411015,21,21,1992,9,male,366,2251,1993,279,375,84,174,195,201
1736833,15,28,1998,4,female,613,4681,907,292,1388,69,866,223,522
1221402,19,29,1994,7,female,482,4043,2248,292,1489,74,276,218,1213
1218112,15,24,1998,7,female,215,2539,122,280,6004,255,2374,25,3630
1672753,18,2,1995,5,female,258,2017,470,279,1147,235,674,44,473
1045456,22,12,1991,5,female,1184,2223,1050,280,630,223,470,57,160
1982338,23,12,1990,12,male,826,2245,1299,285,149,285,139,0,10
2171422,16,5,1997,5,female,405,1911,566,283,2026,283,1830,0,196
1285576,21,14,1992,3,female,1054,2805,802,281,451,281,395,0,56
1000764,17,16,1996,11,female,547,2217,1638,300,172,18,81,282,91
1919096,19,12,1994,8,female,467,2640,792,302,245,9,142,293,103
1779169,15,15,1998,3,female,403,2645,290,303,559,53,480,250,79
1060916,19,15,1994,6,female,568,1923,302,297,1775,173,1210,124,565
1550592,38,21,1975,7,male,827,2542,825,305,1314,198,963,107,351
2119518,14,1,1999,5,female,225,2023,1460,296,3400,296,2162,0,1238
1799588,16,13,1997,11,female,660,4279,612,299,4278,299,3789,0,489
1422110,19,1,1994,11,female,402,4732,196,294,1893,294,1692,0,201
1667033,21,8,1992,7,male,1127,3450,2837,327,243,56,118,271,125
1508572,15,9,1998,7,female,464,2635,403,318,955,27,769,291,186
2158166,16,5,1997,3,female,1192,3817,1688,321,1428,161,939,160,489
1050760,17,17,1996,8,female,655,2722,1008,313,3144,245,2111,68,1033
1212514,17,6,1996,9,female,524,4452,454,328,548,236,264,92,284
1128708,17,16,1996,9,female,278,1915,839,346,4788,195,3351,151,1437
1965680,19,15,1994,4,female,1653,3453,627,345,9071,88,7262,257,1809
1781473,15,2,1998,3,female,449,2113,442,328,720,319,459,9,261
1283801,16,7,1997,1,female,688,2243,559,332,2931,287,1861,45,1070
1008166,16,28,1997,10,female,433,3617,927,338,9852,307,4830,31,5022
1879965,15,31,1998,12,female,575,4173,294,336,1845,336,1205,0,640
1155656,19,17,1994,8,male,647,2114,1915,368,409,11,238,357,171
2176117,15,1,1998,4,male,513,2228,660,356,1323,56,1003,300,320
1680037,19,31,1994,7,male,655,2066,1734,350,1233,1,589,349,644
1931683,18,11,1995,8,female,351,2144,178,351,501,337,187,14,314
1458216,15,15,1998,1,female,882,3407,627,364,1213,285,686,79,527
1565349,19,18,1994,2,female,466,3070,1365,348,2011,344,1449,4,562
1959285,15,11,1998,6,female,655,3742,2009,347,3477,347,2723,0,754
1728221,15,10,1998,8,female,534,3190,936,369,5770,369,4833,0,937
1148141,16,17,1997,7,female,682,3647,1168,355,539,355,419,0,120
1568707,15,18,1998,6,female,776,2228,369,391,747,222,418,169,329
1245957,15,21,1998,9,female,476,2430,2177,390,1613,194,1163,196,450
2039360,16,10,1997,6,female,623,4524,1999,370,2459,152,2035,218,424
1601598,23,19,1990,8,female,1567,2082,644,377,1512,102,1033,275,479
1404979,16,2,1997,8,female,655,2758,1153,386,3592,358,1956,28,1636
1421401,19,16,1994,8,male,1186,2358,1514,385,1023,318,606,67,417
1597854,17,6,1996,7,female,279,2536,178,377,2158,377,1913,0,245
1207962,17,26,1996,4,female,606,4759,1507,420,1190,4,866,416,324
1823425,18,29,1995,4,female,1189,1912,918,418,1087,0,426,418,661
1222311,19,4,1994,4,female,580,3559,2273,412,1417,70,795,342,622
1141988,18,8,1995,11,female,700,4420,1890,417,601,168,386,249,215
1569542,17,14,1996,11,female,646,2164,718,418,1688,273,1501,145,187
2087369,18,18,1995,6,female,1071,4544,1721,421,1158,129,618,292,540
1219750,19,1,1994,6,female,1449,3275,936,416,2665,179,1302,237,1363
1197454,24,30,1989,11,male,451,4653,512,406,797,125,521,281,276
1839020,19,4,1994,4,female,403,3949,1383,403,1501,375,630,28,871
1915130,29,7,1984,8,female,475,3441,2074,408,1638,338,1037,70,601
2142501,17,12,1996,7,female,862,2420,1916,405,1847,404,1399,1,448
1447678,26,28,1987,10,female,998,2136,1108,410,3124,406,2422,4,702
1391158,16,10,1997,4,male,432,2593,165,402,272,402,264,0,8
1623382,18,5,1995,5,female,373,2302,510,398,403,398,324,0,79
1967451,14,3,1999,10,female,336,3426,1073,405,762,405,671,0,91
1784983,23,20,1990,4,male,497,2733,2044,412,832,412,503,0,329
1920304,16,16,1997,2,female,516,2977,2425,443,250,308,166,135,84
1458639,15,13,1998,10,female,634,2990,901,430,3339,178,2067,252,1272
1799620,19,19,1994,4,female,1332,2258,1245,450,1437,142,1063,308,374
1843566,17,8,1996,8,female,949,2697,700,435,3165,378,2316,57,849
1746435,19,25,1994,6,female,686,1938,1357,435,424,432,273,3,151
1850675,18,26,1995,2,female,368,3728,1654,444,574,444,476,0,98
1943044,16,6,1997,8,female,785,2339,802,446,1046,446,830,0,216
1044992,18,4,1995,6,female,897,2564,599,431,684,431,619,0,65
1368252,19,29,1994,10,male,345,3620,1953,432,6373,432,4905,0,1468
1848042,28,17,1985,8,female,508,4562,451,438,4691,438,2850,0,1841
1270799,18,7,1995,7,female,422,2770,1441,462,1495,37,750,425,745
1671000,16,14,1997,1,female,914,2469,1001,468,216,125,110,343,106
1466914,23,1,1990,2,male,1320,2925,1477,466,689,306,397,160,292
1257473,17,24,1996,1,female,258,4230,697,467,1175,239,492,228,683
1894934,17,18,1996,9,male,1575,1932,848,470,4199,116,1619,354,2580
1286085,17,29,1996,8,female,704,2449,860,460,639,438,390,22,249
1893449,15,26,1998,8,female,559,3500,1311,465,743,396,390,69,353
1536090,18,10,1995,11,female,398,4147,926,457,2180,440,1074,17,1106
2113247,18,13,1995,12,female,1556,3158,299,467,1702,409,932,58,770
1214485,18,14,1995,3,female,432,1977,471,475,2204,405,1456,70,748
2010676,16,19,1997,12,male,460,3079,1994,453,254,452,204,1,50
1398154,14,18,1999,8,female,196,3280,836,461,1224,461,973,0,251
2014301,18,10,1995,1,male,804,2710,1149,459,1131,459,838,0,293
1248113,21,26,1992,10,female,718,4698,811,475,871,475,759,0,112
1483216,18,29,1995,8,male,616,4431,188,509,6103,40,2362,469,3741
1899239,19,24,1994,4,male,1296,3639,1616,514,962,20,228,494,734
1850094,18,5,1995,5,male,532,2318,1754,515,527,318,478,197,49
1114537,17,29,1996,8,male,1088,4524,2610,505,1111,168,383,337,728
1166881,18,18,1995,1,female,695,4535,1916,492,983,322,511,170,472
1436583,18,11,1995,4,female,540,2078,762,515,2924,111,1442,404,1482
1141239,24,14,1989,4,female,217,2376,1442,487,1681,170,970,317,711
1034591,16,11,1997,2,female,826,2825,1002,514,502,462,429,52,73
1930748,16,2,1997,4,female,658,4705,282,518,699,385,363,133,336
1849008,14,10,1999,2,female,952,2858,305,514,2133,451,1589,63,544
1284401,22,18,1991,6,male,65,2685,1832,507,3508,494,2994,13,514
1408526,17,20,1996,5,male,517,2458,1710,484,716,481,660,3,56
1654139,18,8,1995,5,female,793,1944,1193,488,291,488,193,0,98
1297341,17,12,1996,7,male,711,2756,2338,511,627,511,504,0,123
2070428,18,16,1995,2,female,1000,2493,888,511,1804,511,1635,0,169
1601244,18,9,1995,7,female,483,3330,781,513,4187,513,3958,0,229
2126936,24,28,1989,5,female,1329,4390,1214,526,978,62,519,464,459
1280332,24,16,1989,8,male,1594,4306,2323,561,1353,6,1006,555,347
1120488,17,14,1996,4,female,428,2179,721,533,703,155,390,378,313
1240333,19,9,1994,10,female,1583,2224,940,538,698,321,250,217,448
1493724,16,22,1997,10,female,718,3412,583,530,1649,248,635,282,1014
1742814,15,29,1998,8,female,625,2825,1281,528,3535,451,3060,77,475
1359188,16,14,1997,4,female,757,1938,1306,591,575,76,149,515,426
1227765,17,18,1996,10,female,911,1999,1135,599,393,72,230,527,163
1210384,17,10,1996,6,male,503,2012,528,568,1581,104,360,464,1221
1562482,19,18,1994,4,male,854,2001,540,567,5133,167,4436,400,697
1057867,19,23,1994,4,female,362,2051,658,571,2863,403,1770,168,1093
1082314,19,20,1994,9,male,605,2111,1462,569,1637,227,776,342,861
1932226,21,29,1992,7,female,975,2861,1106,563,973,362,493,201,480
1734793,23,16,1990,8,female,1432,4505,416,570,1019,340,866,230,153
1591060,18,3,1995,10,female,247,2624,1770,580,528,435,443,145,85
1364326,17,6,1996,6,female,732,2712,522,588,1896,469,764,119,1132
1619348,21,12,1992,2,female,1311,4211,1212,569,1277,422,304,147,973
1551348,17,27,1996,2,female,447,2083,311,599,1372,598,1048,1,324
1861684,23,25,1990,1,female,486,1987,748,607,515,607,361,0,154
2140658,18,2,1995,6,female,321,2998,865,577,3391,577,2635,0,756
1352830,16,29,1997,5,male,990,3556,1677,644,1381,37,830,607,551
1229700,16,14,1997,5,male,742,2264,1669,663,1362,78,717,585,645
1022725,19,13,1994,9,male,432,2764,2018,637,352,375,299,262,53
2073911,16,5,1997,12,female,498,1929,207,645,866,399,706,246,160
2022668,16,25,1997,2,male,804,2072,1498,626,565,269,429,357,136
1239034,16,25,1997,9,female,494,2928,320,652,842,407,290,245,552
1973377,18,10,1995,4,female,585,3898,2147,662,1185,264,791,398,394
1144249,19,1,1994,7,female,327,3036,1141,644,1394,430,463,214,931
1504420,20,6,1993,6,female,543,3437,786,663,3794,219,2480,444,1314
1681169,34,2,1979,7,male,644,2441,577,626,7297,228,3618,398,3679
2186091,41,9,1972,7,female,1137,2020,123,655,276,576,170,79,106
1292451,20,16,1993,9,female,640,2502,1429,658,791,593,507,65,284
2115905,14,24,1999,10,female,185,2007,861,648,2192,570,1304,78,888
2174049,20,31,1993,12,male,1716,2858,825,640,2552,465,1727,175,825
1101955,19,2,1994,3,female,598,4557,1355,618,4986,617,3835,1,1151
1567592,18,14,1995,1,female,425,2966,448,662,65,662,61,0,4
1947208,24,1,1989,2,male,906,3118,2220,625,1541,625,1344,0,197
1019379,22,2,1991,8,female,1489,2185,674,704,641,117,385,587,256
2030365,23,19,1990,2,male,1675,4705,2291,687,2291,84,1365,603,926
1137495,17,20,1996,10,male,338,2393,499,687,583,459,418,228,165
1887875,19,8,1994,1,female,583,2175,1025,707,703,271,410,436,293
2070446,21,28,1992,11,female,1474,1984,189,685,530,353,280,332,250
1292549,16,16,1997,4,female,674,1938,371,690,1694,336,1206,354,488
2030777,16,26,1997,7,female,831,2074,546,674,5097,223,4192,451,905
1742615,17,24,1996,2,male,312,2354,1582,679,1805,257,1391,422,414
1033851,19,28,1994,6,female,581,3118,1782,724,3589,484,2126,240,1463
2149030,20,31,1993,10,female,758,2885,850,665,1480,207,639,458,841
1844996,21,8,1992,5,female,817,2218,492,669,1286,246,711,423,575
1480607,17,26,1996,6,female,786,2253,1355,670,1743,502,759,168,984
2074014,19,25,1994,12,female,610,1933,982,683,1271,563,763,120,508
1590957,23,8,1990,8,female,1231,2604,543,679,3020,529,2635,150,385
2187614,15,2,1998,5,female,614,2907,866,667,528,666,256,1,272
1116472,23,23,1990,4,male,1142,2964,2396,706,2074,703,1650,3,424
1550870,16,21,1997,11,female,511,3567,810,695,1842,695,1596,0,246
2163907,15,11,1998,1,female,313,3707,530,740,781,68,222,672,559
1601426,17,24,1996,12,female,1426,3384,1100,756,646,111,462,645,184
1804329,17,28,1996,9,male,334,3767,2168,766,1036,25,433,741,603
1086822,18,28,1995,1,female,645,2245,462,765,1069,390,517,375,552
1299454,16,14,1997,7,female,776,2993,1681,768,3659,248,2211,520,1448
1337853,19,11,1994,4,male,626,2115,508,776,1897,472,1521,304,376
1105790,20,29,1993,3,female,1519,2669,940,769,1354,211,1003,558,351
1771828,18,5,1995,6,female,344,2204,498,774,805,739,477,35,328
2125985,16,25,1997,1,female,1464,4604,730,793,1370,664,588,129,782
1192042,20,27,1993,12,female,1356,4767,2061,791,6077,746,3769,45,2308
1990873,20,22,1993,12,female,837,3079,280,768,2140,638,1413,130,727
1825400,23,19,1990,1,male,846,4260,1176,764,2050,629,712,135,1338
2107637,38,24,1975,11,female,1292,3044,1712,730,2735,707,2531,23,204
1894505,24,18,1989,10,female,673,2361,368,757,3418,753,1851,4,1567
1275846,39,2,1974,2,male,526,4297,1279,787,2855,786,1302,1,1553
2055573,18,30,1995,6,female,416,3386,735,733,1557,733,808,0,749
1405803,25,11,1988,8,male,667,3820,2836,835,377,107,106,728,271
1356284,17,5,1996,5,female,254,3735,486,852,929,163,412,689,517
2188467,18,5,1995,5,male,1010,2958,2195,806,764,75,458,731,306
2146524,20,14,1993,12,male,688,2596,1127,804,1259,52,721,752,538
1800318,19,11,1994,2,female,1051,3951,568,862,3032,66,1386,796,1646
2068044,23,14,1990,3,female,1641,2520,2157,869,2377,115,1415,754,962
1129904,15,6,1998,1,female,680,2310,365,816,323,567,284,249,39
1408420,15,30,1998,5,female,1457,2989,607,842,1254,196,782,646,472
1842822,17,28,1996,2,female,414,2275,1626,821,607,319,405,502,202
1042543,19,12,1994,4,female,521,2186,143,823,3934,380,1148,443,2786
1760041,19,19,1994,6,female,484,3463,1024,875,2000,373,674,502,1326
1708950,20,18,1993,4,female,850,2387,566,874,2374,283,1101,591,1273
2095963,14,10,1999,5,male,662,1911,1475,804,1205,784,844,20,361
1568432,17,26,1996,7,female,766,3163,2160,817,1127,763,1057,54,70
1310982,17,24,1996,7,female,629,3505,1224,861,846,836,748,25,98
1303068,18,1,1995,3,female,1678,1977,769,832,690,693,527,139,163
1604095,15,21,1998,12,female,371,4826,97,815,4801,737,3843,78,958
1073794,19,5,1994,12,female,373,4589,1720,841,10253,663,2982,178,7271
1645807,20,10,1993,12,female,459,4710,894,879,4830,671,3180,208,1650
2047058,19,5,1994,9,female,432,1956,221,819,16393,654,11043,165,5350
1845678,20,7,1993,2,female,1669,3765,950,816,1382,619,1035,197,347
2150204,18,24,1995,12,female,583,3013,972,864,2973,864,2609,0,364
1460631,16,17,1997,8,male,313,2580,1729,887,405,41,209,846,196
1785570,17,8,1996,1,female,510,3197,1147,899,337,38,110,861,227
1127854,17,23,1996,6,female,570,2081,710,952,3297,124,1182,828,2115
1871174,20,30,1993,3,female,968,3071,1827,936,3038,110,1741,826,1297
1537257,15,20,1998,10,female,619,4468,751,959,970,642,854,317,116
1822186,14,27,1999,4,female,334,2091,474,899,2297,287,1919,612,378
1902732,16,19,1997,11,female,696,2524,751,935,1490,189,467,746,1023
1256914,15,27,1998,10,female,1189,3438,2559,951,1543,398,626,553,917
1375543,18,10,1995,12,male,728,1941,416,955,4753,308,2844,647,1909
1239973,17,26,1996,4,female,936,4417,1781,910,1851,548,610,362,1241
1949247,19,9,1994,11,female,434,4189,3594,927,2859,528,1290,399,1569
1727588,19,23,1994,7,female,739,2182,1045,981,1835,201,1040,780,795
1589495,19,25,1994,7,male,409,2053,314,891,2745,514,2296,377,449
1744078,22,23,1991,3,female,84,4508,195,905,4844,538,1001,367,3843
2110563,23,9,1990,1,female,709,2015,707,890,1470,214,321,676,1149
1122346,23,10,1990,10,female,1690,2177,353,927,1483,572,230,355,1253
1959804,18,7,1995,1,female,644,2778,1131,962,856,878,612,84,244
1862167,19,25,1994,1,female,704,1935,542,928,1043,916,900,12,143
1801945,19,31,1994,10,female,1528,4320,737,903,1136,743,283,160,853
1312899,16,19,1997,8,female,459,2080,611,888,2166,752,959,136,1207
1934087,19,19,1994,5,male,575,4516,3078,954,3075,834,2464,120,611
2006222,15,19,1998,6,female,586,2026,870,917,1815,910,1067,7,748
1321655,19,9,1994,6,female,268,3035,281,932,1904,932,1446,0,458
1183666,14,20,1999,10,female,232,2697,479,1021,1869,90,1293,931,576
2022737,16,29,1997,6,male,438,2052,1046,1043,588,241,208,802,380
1188002,17,2,1996,4,female,53,2312,1121,1005,497,207,301,798,196
1799059,15,4,1998,10,female,1095,4233,1329,1042,1491,735,616,307,875
1868869,14,2,1999,8,female,445,1970,1397,1128,8581,331,1989,797,6592
2144524,17,6,1996,11,female,151,3125,471,1071,5530,652,3990,419,1540
1071836,16,2,1997,6,female,377,4105,306,1005,1805,391,354,614,1451
1605870,20,14,1993,9,female,25,4576,1710,1006,2293,299,1453,707,840
1869228,14,8,1999,2,female,191,2199,1410,1083,1579,856,858,227,721
1116336,16,23,1997,11,male,506,3561,260,1066,1136,876,625,190,511
2057051,18,6,1995,2,female,391,2259,1415,1083,15731,1061,5860,22,9871
1190613,20,19,1993,3,female,746,4483,863,998,3379,905,1887,93,1492
1591857,24,22,1989,12,female,797,2351,838,1054,1870,1000,1339,54,531
1878691,17,13,1996,6,female,666,2204,1431,1114,1221,1114,909,0,312
2025395,18,12,1995,10,female,247,2839,1420,1042,1300,1042,801,0,499
1974177,18,24,1995,1,male,623,2255,1815,1050,2136,1050,1851,0,285
1913961,21,16,1992,9,female,412,4546,422,1064,2794,1064,2477,0,317
1384977,17,14,1996,4,female,980,3470,1540,1202,1321,230,768,972,553
1971818,14,9,1999,3,female,171,2173,1365,1265,7702,118,5921,1147,1781
1756627,17,1,1996,7,male,225,1956,710,1181,3671,203,2430,978,1241
1160771,26,15,1987,3,female,1013,4604,726,1171,2050,10,653,1161,1397
1906328,17,19,1996,9,male,840,2091,1368,1188,871,755,586,433,285
2136449,19,6,1994,5,female,589,2576,766,1197,1616,595,1418,602,198
1760783,15,18,1998,3,female,282,1989,439,1247,2820,698,858,549,1962
1309290,15,9,1998,4,female,43,2112,222,1267,6336,598,1839,669,4497
1540687,15,5,1998,9,female,417,4191,382,1253,3937,413,2032,840,1905
1334136,17,26,1996,12,female,562,3032,330,1166,1862,389,539,777,1323
1431951,19,4,1994,3,female,389,3003,398,1176,2256,632,1709,544,547
1579327,19,24,1994,5,female,421,4295,897,1183,2123,444,1031,739,1092
1807563,22,6,1991,8,male,1547,3746,2373,1280,9503,329,5318,951,4185
1395581,23,23,1990,1,male,679,2027,601,1280,9570,314,3811,966,5759
2092631,23,11,1990,10,male,285,4478,275,1154,4371,426,3563,728,808
1030958,17,23,1996,3,female,600,2540,2142,1185,1193,1039,1035,146,158
1778029,15,26,1998,12,female,241,3532,269,1202,3676,1149,3348,53,328
1148962,14,21,1999,1,female,202,2998,1505,1205,5407,1184,2146,21,3261
1255972,14,5,1999,5,female,183,2375,553,1178,2165,1093,764,85,1401
1695259,14,12,1999,6,female,566,4615,1848,1257,4680,978,2034,279,2646
1182164,17,12,1996,4,female,434,3813,1936,1281,3005,1255,1390,26,1615
1172044,18,12,1995,10,female,239,2227,1144,1201,10905,1110,6620,91,4285
2118039,20,20,1993,9,female,788,4540,2145,1169,482,1169,375,0,107
1785442,37,26,1976,5,female,270,3676,124,1222,11443,1222,4787,0,6656
1992431,24,17,1989,6,female,1486,1986,1245,1464,1962,83,420,1381,1542
1139873,14,19,1999,9,female,1061,4418,1128,1338,2758,144,1179,1194,1579
1479575,20,15,1993,11,female,835,3170,1768,1485,4604,264,2064,1221,2540
2175539,19,3,1994,1,female,584,2249,657,1289,419,797,150,492,269
1925828,16,5,1997,7,female,491,3357,1842,1414,1529,727,1037,687,492
1500599,17,23,1996,3,male,561,2347,1411,1353,1636,885,749,468,887
1833990,24,30,1989,4,female,1663,2039,1100,1390,1546,932,1296,458,250
2020433,27,12,1986,12,female,1487,2907,983,1488,1245,602,518,886,727
1477284,15,2,1998,5,female,1188,1937,624,1513,6434,477,4362,1036,2072
1226940,15,24,1998,5,female,665,2935,1660,1353,5977,733,4459,620,1518
1484176,17,10,1996,12,female,756,4458,1492,1485,6365,776,4355,709,2010
1273199,16,14,1997,2,female,589,2972,1717,1319,2864,355,971,964,1893
1925562,16,17,1997,8,female,1177,3995,1367,1409,9705,921,8690,488,1015
1343302,20,5,1993,12,male,1252,2763,1920,1367,3632,814,1698,553,1934
1359370,19,16,1994,2,female,668,3675,764,1337,4036,564,2812,773,1224
1669037,19,5,1994,5,female,962,3499,794,1451,2821,975,1416,476,1405
1983513,21,13,1992,3,female,1501,3353,1561,1346,2034,825,591,521,1443
1762561,28,14,1985,8,male,1193,2416,745,1425,10257,723,4306,702,5951
1078115,19,1,1994,1,male,396,4770,639,1345,1951,1279,1686,66,265
1949519,20,17,1993,3,female,596,4585,1744,1350,1963,1307,1431,43,532
1008629,14,26,1999,7,female,357,4641,755,1403,2786,1282,756,121,2030
1250409,15,5,1998,2,female,341,2159,656,1476,3821,1156,3046,320,775
1557619,18,15,1995,12,female,438,3547,1205,1337,2011,1278,1053,59,958
1327875,17,13,1996,6,female,107,2170,195,1428,3651,1276,2791,152,860
2177920,21,17,1992,9,female,968,3279,2693,1402,2226,1346,1976,56,250
1675135,36,5,1977,5,female,184,4138,122,1315,5558,1104,3173,211,2385
2042824,18,25,1995,1,male,51,4817,32,1346,52964,1342,18925,4,34039
2051909,25,10,1988,6,male,533,1913,1726,1474,207,1474,185,0,22
1807752,16,15,1997,1,female,885,2502,1315,1870,883,40,240,1830,643
1195674,17,12,1996,8,female,376,2298,448,1808,1996,70,1095,1738,901
1839680,18,6,1995,10,female,405,2065,277,1817,2218,7,1250,1810,968
2148846,38,16,1975,2,female,1384,2729,1871,1686,1609,42,662,1644,947
2061020,18,2,1995,8,female,1035,4566,646,1726,4258,19,1746,1707,2512
1078916,20,13,1993,1,male,959,4499,2501,1720,5895,232,4226,1488,1669
1164641,36,15,1977,8,male,449,2856,1674,1532,3658,16,732,1516,2926
2051262,14,11,1999,5,male,873,3463,2110,1659,1385,442,784,1217,601
1376321,15,7,1998,4,female,10,2080,422,1617,2217,705,1746,912,471
1173053,17,8,1996,10,female,532,3894,366,1848,1444,1332,1248,516,196
1513598,18,25,1995,4,male,735,1998,703,1760,1584,584,736,1176,848
1424581,19,20,1994,9,female,1177,2507,1610,1746,2458,726,1922,1020,536
1546204,31,20,1982,6,female,937,2298,1045,1870,2241,704,1502,1166,739
1535642,15,3,1998,4,female,520,2263,426,1751,4833,739,2414,1012,2419
1476056,17,15,1996,3,female,1150,2581,587,1549,4415,502,1249,1047,3166
1936854,17,15,1996,8,female,378,2200,492,1820,3543,1161,2074,659,1469
1867413,18,1,1995,8,female,1801,3237,411,1603,2694,530,1687,1073,1007
1350156,20,24,1993,3,male,508,4249,862,1758,5294,645,1894,1113,3400
1685573,38,20,1975,2,male,1930,4845,942,1768,4886,1208,1619,560,3267
1248835,14,30,1999,11,female,460,2611,656,1551,1781,1355,1131,196,650
1905394,14,7,1999,8,female,309,3303,1284,1819,2384,1781,725,38,1659
1452582,18,30,1995,7,female,717,2123,713,1767,2623,1743,2197,24,426
1284567,18,24,1995,8,female,48,2068,1137,1645,1178,1508,941,137,237
1136908,20,19,1993,9,male,435,2939,984,1856,2704,1523,2397,333,307
1519813,21,7,1992,4,female,2314,3135,1441,1725,2441,1563,1193,162,1248
1526069,16,29,1997,3,female,938,4697,924,1823,2791,1600,2460,223,331
2192435,17,23,1996,4,female,664,2517,508,1542,3212,1302,544,240,2668
1001431,18,28,1995,6,female,1249,2843,828,1679,5765,1359,4106,320,1659
1842048,18,1,1995,1,female,495,3740,1922,1696,2470,1690,1781,6,689
1842946,18,6,1995,1,male,458,2159,1249,1525,1108,1525,906,0,202
1903656,17,10,1996,9,female,357,4654,141,1608,9592,1608,7068,0,2524
1844239,19,27,1994,11,female,553,4103,753,1690,5221,1690,4586,0,635
1861730,21,19,1992,4,female,1177,3442,1037,1571,7340,1571,4816,0,2524
1661104,15,1,1998,6,female,500,3478,902,2318,1703,244,710,2074,993
1584317,17,3,1996,1,female,707,2178,526,2252,2848,64,1751,2188,1097
1817366,18,20,1995,1,female,1297,2447,1036,2164,2945,108,1360,2056,1585
1593513,16,21,1997,6,female,426,3282,426,1872,5435,353,2595,1519,2840
1924964,19,1,1994,7,male,487,3285,1256,2094,5122,16,2619,2078,2503
1693605,19,27,1994,8,female,600,3719,1761,1918,3896,77,1499,1841,2397
1518354,22,23,1991,2,female,301,2553,699,2148,6220,124,1342,2024,4878
1715925,23,4,1990,9,female,705,4077,793,1877,152014,80,89911,1797,62103
1219473,18,13,1995,6,female,1103,4021,1325,2067,1028,883,540,1184,488
1069526,18,10,1995,10,female,621,3216,1626,2017,1995,822,983,1195,1012
1872383,21,7,1992,4,female,1176,2207,965,2213,2138,550,684,1663,1454
1182272,17,16,1996,12,female,1082,4464,1716,2049,17159,681,9657,1367,7502
1535797,16,27,1997,7,female,1251,2768,1042,2053,20303,540,11881,1513,8422
1640120,17,13,1996,9,female,1084,2011,1040,2104,3277,1021,1209,1083,2068
1509407,18,23,1995,1,female,451,1970,197,2321,10192,1233,7750,1088,2442
1063988,22,24,1991,12,male,330,4754,506,1950,3369,424,1977,1526,1392
1746334,22,6,1991,10,female,1344,4306,983,1970,7907,652,3868,1318,4039
1075221,22,23,1991,5,male,907,4693,3024,2028,948,1990,517,38,431
2165022,15,7,1998,4,female,469,2397,510,2065,1489,2027,1109,38,380
1113528,15,1,1998,5,female,458,2225,641,2124,1486,1852,1261,272,225
1892160,17,21,1996,2,female,1063,3891,623,2122,2061,2054,708,68,1353
1086672,17,16,1996,7,female,668,1921,368,2147,1402,1893,1083,254,319
1076918,18,12,1995,6,female,601,2855,1521,1911,1767,1452,1369,459,398
1866809,20,12,1993,12,female,763,1931,1021,2108,2481,2001,1105,107,1376
1052695,22,23,1991,9,female,874,4297,3654,1968,2006,1825,1632,143,374
1005926,24,30,1989,11,female,556,2044,847,1963,1809,1681,1176,282,633
1638678,25,16,1988,12,male,1329,3276,1050,2269,3060,2051,1221,218,1839
1737135,15,14,1998,4,female,387,2434,1025,2158,17066,1606,11772,552,5294
1967496,15,2,1998,4,female,109,3584,132,1966,7444,1870,5679,96,1765
1772227,16,18,1997,5,female,282,3792,581,2259,4788,1994,3587,265,1201
1244332,16,31,1997,7,female,419,4663,542,2119,4404,1678,3027,441,1377
1939424,18,28,1995,7,female,454,2520,1672,1914,5195,1804,2046,110,3149
1249387,18,26,1995,9,male,1278,2133,702,2075,8095,1936,7173,139,922
1571217,19,25,1994,9,male,225,2321,884,2105,3341,1616,2228,489,1113
1128034,23,29,1990,10,female,795,3993,198,2112,4548,1946,2375,166,2173
1603868,24,8,1989,6,female,601,3769,479,2128,6362,1899,2289,229,4073
2082096,33,29,1980,10,female,2373,2870,2265,2097,4442,1989,2208,108,2234
1731299,17,2,1996,2,female,829,2838,2137,2320,1366,2312,1275,8,91
1314660,18,9,1995,9,female,535,2597,1052,1927,3924,1911,3148,16,776
1878887,16,12,1997,5,female,350,3704,528,2274,1163,2274,970,0,193
1430725,38,5,1975,5,male,446,4413,315,1962,650,1962,571,0,79
1761089,16,10,1997,3,female,587,2121,984,2308,3359,2308,3175,0,184
1015766,19,21,1994,8,female,547,2027,1316,2133,1357,2133,1175,0,182
1280902,17,28,1996,1,female,440,2770,700,2041,4932,2041,4230,0,702
2047056,19,22,1994,9,female,553,3014,584,1949,6011,1949,1897,0,4114
1077619,26,10,1987,10,female,950,2832,145,1954,4671,1954,4162,0,509
1480563,18,23,1995,4,male,486,2191,1509,3150,2344,59,1595,3091,749
1110149,18,15,1995,5,female,430,2435,1614,2840,3135,536,1061,2304,2074
1763081,20,13,1993,10,male,302,2373,437,2399,1652,324,1083,2075,569
1900164,23,20,1990,6,male,1026,2352,790,3228,4077,0,1657,3228,2420
1657039,15,24,1998,3,female,1071,2111,860,3025,5183,533,2480,2492,2703
1959232,17,20,1996,5,female,1151,2184,1584,3156,9863,610,3244,2546,6619
1264500,18,11,1995,6,male,516,2129,1678,2803,4724,62,2647,2741,2077
1522003,21,18,1992,2,female,1251,3494,1369,2430,4857,278,1340,2152,3517
1967555,24,15,1989,11,female,219,4587,583,2776,6652,171,4245,2605,2407
1053087,23,6,1990,6,male,596,4320,836,2996,82623,179,43410,2817,39213
1839000,23,11,1990,4,male,883,2211,1684,3294,546,1447,496,1847,50
1954646,22,7,1991,10,male,274,4078,773,3228,1956,1957,1436,1271,520
2159412,15,22,1998,11,female,1041,4452,662,2596,3212,1422,1863,1174,1349
1239018,15,29,1998,9,female,596,4080,793,3306,3069,1898,741,1408,2328
1100631,20,16,1993,10,male,642,2033,613,2708,3969,1448,1710,1260,2259
1033997,22,29,1991,9,female,742,4199,944,3070,4431,799,1154,2271,3277
1090279,17,17,1996,6,female,1110,4564,2565,2711,5451,709,3044,2002,2407
2186319,18,27,1995,9,female,1544,2242,1756,3090,6645,1511,3586,1579,3059
1556932,22,8,1991,1,female,172,3055,715,2636,6993,719,1887,1917,5106
1972989,15,29,1998,1,female,499,4731,930,2408,479,1835,244,573,235
1401489,18,22,1995,3,female,404,3769,2550,3162,1258,2941,630,221,628
1789467,16,9,1997,7,female,584,4638,1033,2402,2947,2064,2582,338,365
1430616,16,9,1997,8,female,717,2733,724,2671,1923,2334,1405,337,518
2010847,18,10,1995,2,female,1084,4509,3233,2672,2053,2009,1074,663,979
1266118,20,11,1993,7,female,926,2843,1042,3547,2317,3276,1262,271,1055
2075815,20,16,1993,7,female,464,3411,529,3158,2061,2604,838,554,1223
1077282,21,24,1992,3,male,1766,2352,180,2897,2317,2751,2111,146,206
1585181,15,20,1998,5,male,336,1993,267,2964,5546,2865,4202,99,1344
1038391,19,19,1994,8,male,415,2054,1060,2403,8753,1957,5739,446,3014
1617578,20,11,1993,7,female,526,4665,687,3360,7446,2911,7013,449,433
1532834,22,23,1991,11,female,152,4696,231,2724,6012,2150,3207,574,2805
1981996,16,6,1997,8,female,682,3358,2239,2665,5721,2664,4735,1,986
1198514,20,13,1993,12,female,228,2052,968,3393,1790,3393,1483,0,307
1248163,15,29,1998,5,female,484,4530,2097,2394,6536,2394,5044,0,1492
1998811,17,7,1996,1,female,189,3521,704,2583,4389,2583,3840,0,549
1218476,21,7,1992,1,female,407,2553,1767,2415,5345,2415,4461,0,884
1597192,17,4,1996,11,male,54,2842,2276,3701,1908,482,392,3219,1516
1770193,17,20,1996,2,female,752,2040,608,3674,1529,68,432,3606,1097
1620281,17,18,1996,8,female,1613,2268,1342,8432,3214,553,1468,7879,1746
1983951,20,23,1993,12,female,792,2624,517,7460,2513,958,1670,6502,843
1711518,19,10,1994,8,female,622,2560,925,3585,773,31,596,3554,177
1565995,20,9,1993,6,female,659,2007,1095,3817,644,201,314,3616,330
1085984,21,14,1992,10,male,993,2245,1397,6040,2568,18,771,6022,1797
1180095,13,23,2000,2,female,188,2028,925,4142,3095,232,454,3910,2641
1808820,16,10,1997,10,female,151,2051,941,3631,3750,720,1710,2911,2040
1417328,19,10,1994,11,female,836,4568,1738,3946,3794,2,2412,3944,1382
1766297,18,8,1995,7,female,1174,2209,1184,5006,5190,374,3187,4632,2003
1841932,18,6,1995,8,female,953,2569,1275,3810,3571,43,1244,3767,2327
1429178,18,22,1995,9,female,888,4733,519,16583,16743,1718,10104,14865,6639
1712413,20,7,1993,11,female,508,2583,646,5025,5969,134,2471,4891,3498
1350506,19,20,1994,8,female,397,3055,2199,8305,6801,1287,4027,7018,2774
1717724,20,14,1993,9,female,242,2355,1773,3981,3391,405,2447,3576,944
2041648,15,29,1998,8,female,893,3893,715,4236,10510,718,2926,3518,7584
1781243,17,1,1996,5,female,976,3683,755,10478,42449,246,27353,10232,15096
1559908,20,4,1993,12,female,1334,4622,1819,4280,45633,472,30754,3808,14879
1298331,19,7,1994,9,female,1059,3776,1068,6912,27029,1197,12019,5715,15010
1914977,20,15,1993,1,female,712,3131,935,11142,37450,887,14806,10255,22644
2050257,20,9,1993,8,male,940,2291,655,3834,8861,2,1339,3832,7522
1771772,23,4,1990,2,female,1179,3840,1830,9734,23008,1373,11651,8361,11357
2144652,16,25,1997,11,female,342,2944,1530,8257,3950,3061,2762,5196,1188
1448930,17,11,1996,10,female,1316,4357,1810,10433,3066,7427,2119,3006,947
1090396,19,31,1994,12,female,247,2653,702,10386,5354,4451,2140,5935,3214
1783264,20,1,1993,3,male,267,2536,610,14355,5151,8591,3461,5764,1690
1269167,31,30,1982,4,male,513,3696,2579,6448,3687,2768,3210,3680,477
1856665,34,22,1979,11,male,392,2634,2201,4202,2458,1736,1684,2466,774
1103175,15,24,1998,8,female,487,3661,3086,6815,6177,1500,3990,5315,2187
1697605,16,16,1997,3,female,542,2824,1122,11506,9269,3177,5639,8329,3630
1287555,16,31,1997,5,female,558,2219,1712,9633,8874,5744,3841,3889,5033
1852952,17,19,1996,1,male,243,1960,1569,11439,10850,7065,5514,4374,5336
1131001,17,3,1996,3,female,1153,4630,1797,4590,3295,1709,1379,2881,1916
1159082,17,31,1996,5,female,728,2015,607,3922,5664,1938,3791,1984,1873
1415543,19,1,1994,7,female,511,2954,1069,4217,3696,2828,2242,1389,1454
1240778,20,27,1993,1,male,483,2803,2306,4645,3668,2487,2165,2158,1503
2000261,21,19,1992,3,female,1269,2047,640,5155,4077,1770,2522,3385,1555
1070396,37,29,1976,2,female,878,2738,2021,6294,6258,2416,3845,3878,2413
1292537,16,19,1997,1,female,631,3763,498,6369,19397,2386,12342,3983,7055
1745067,17,1,1996,1,female,947,4290,3238,3780,8185,1233,5380,2547,2805
1818104,17,7,1996,3,female,519,2238,1689,5591,15623,2753,11819,2838,3804
1710440,18,1,1995,1,female,404,2014,1324,5455,15089,2191,3799,3264,11290
1441066,18,12,1995,9,male,969,3494,2309,8210,13971,2399,7645,5811,6326
1330487,19,1,1994,1,male,594,3564,781,4007,6578,2796,3520,1211,3058
1982264,19,5,1994,10,male,856,2225,1622,8256,16150,4097,11523,4159,4627
1947946,20,11,1993,2,female,528,2016,803,5407,15036,1094,9022,4313,6014
1344342,20,18,1993,6,female,476,3599,2198,7594,15413,5373,6189,2221,9224
2185422,20,18,1993,8,female,1486,4132,1780,3781,22633,2514,12404,1267,10229
1569422,20,5,1993,8,female,1015,2565,1071,10020,16336,6631,9790,3389,6546
1007328,23,5,1990,11,female,1042,4620,1806,4756,9787,2574,6345,2182,3442
1926313,22,26,1991,3,female,1505,4336,1221,4539,9920,2303,7063,2236,2857
2079095,23,16,1990,9,male,417,3464,1296,8244,12435,3168,7342,5076,5093
1836366,26,3,1987,8,female,1669,4240,857,4794,28778,1153,20770,3641,8008
1963699,18,17,1995,10,female,445,1921,858,8719,584,8142,251,577,333
1390362,17,5,1996,8,female,716,3738,2060,4790,2475,4269,1716,521,759
1638976,18,15,1995,1,female,401,2281,1790,7176,3256,6993,2397,183,859
1991657,15,13,1998,5,female,594,4631,1947,12234,14095,12083,10056,151,4039
1184126,15,20,1998,9,female,636,2769,453,6135,5444,5515,4021,620,1423
1277820,17,27,1996,11,female,1005,4351,2210,5045,4498,4742,3909,303,588
1364616,18,23,1995,12,female,508,3917,1872,3664,3058,3228,2349,436,709
1757787,18,26,1995,3,female,592,2426,585,8667,9534,7539,6731,1128,2803
1674381,18,25,1995,5,female,853,4417,1062,5765,6533,4215,5200,1550,1333
1299870,18,16,1995,8,male,894,3440,1138,3835,3833,3269,2221,566,1612
1043082,18,24,1995,10,female,356,1958,957,3981,5968,3215,2636,766,3332
1364887,20,29,1993,7,female,1089,2392,1408,5339,4964,4119,2366,1220,2598
1729341,21,20,1992,10,male,587,2784,809,5177,5423,4759,3278,418,2145
1008872,25,5,1988,9,female,273,2332,1849,6135,4952,6029,4547,106,405
1099760,15,29,1998,12,female,546,3712,482,6285,9515,5575,7780,710,1735
1422393,19,27,1994,11,female,456,3850,1311,4151,17117,3981,9370,170,7747
1654565,19,15,1994,8,male,394,4538,4144,4501,15088,4435,5961,66,9127
2063006,20,4,1993,1,female,402,1988,332,7351,106025,7248,73333,103,32692
1132164,20,9,1993,10,female,699,3611,973,4507,7768,4414,6909,93,859
1668695,24,25,1989,4,female,182,2938,1272,6018,17765,5843,11708,175,6057
1458985,28,14,1985,12,female,290,2218,1618,4626,10268,4290,4250,336,6018
1256153,18,12,1995,3,female,21,1968,1720,4401,13412,4399,10592,2,2820
1195943,15,10,1998,5,female,111,2002,1524,11959,12554,11959,11462,0,1092
1468023,23,11,1990,4,female,416,2560,185,4506,6516,4506,5760,0,756
1397896,39,15,1974,5,female,397,2049,768,9410,12443,9410,9530,0,2913
